她	ta	1
趣	qut
二	era
壬	rfp
右	yzu
时	uio
础	iuu
噢	ook
醅	pwy
吖	aak
鸽	ger
盉	heh
玖	jqw
渴	ked
崽	zdu
孝	xnl
丛	csr
遮	vez
叭	bak
倪	nir
嘛	mak
肮	aho
袄	aop
扒	baf
宝	bcb
栟	bfm
泵	bgu
邦	bhf
毕	bib
病	bkb
摽	bnf
泊	bod
卑	bwp
曹	ccc
苍	chc
瓷	cid
惭	cjx
锉	coj
存	cyu
德	der
党	dhx
堤	dit
儋	djr
疔	dkb
簟	dmv
鲷	dny
惰	dox
迭	dpz
恫	dsx
蠹	dug
怼	dvy
囤	dyk
锋	fgj
邡	fhf
篚	fwv
膏	gcw
盖	gdy
冈	ghk
玕	gjw
官	grb
骨	gug
簋	gvv
钩	gzj
孩	hdz
盒	her
桁	hgm
颔	hjr
荒	hlc
惑	hog
擐	hrf
纮	hss
祜	hup
徽	hvr
浑	hyd
厚	hzi
叉	iay
珵	igw
嗤	iik
颤	ijw
惙	iox
涌	isd
琡	iuw
圌	ivk
近	jbz
及	jip
奖	jll
检	jmm
嚼	jnk
揭	jpf
九	jqp
镌	jrj
冏	jsk
惧	jux
架	jxl
畯	jyt
犒	kcn
磕	keu
扛	khf
砍	kju
𫛭	klq
括	kof
圐	kuk
揦	laf
檩	lbm
耢	lcl
坜	lit
领	lkr
晾	llo
络	los
烈	lpd
溜	lqd
鹭	luz
檑	lwm
娄	lzm
嘛	mak
贸	mcp
檬	mgm
密	mib
万	moa
湄	mwd
哪	nek
昵	nio
嬢	nln
袅	nnn
弩	nun
噢	ook
鸥	ouq
贫	pbf
排	pdf
抨	pgf
披	pif
爿	pjv
飘	pnx
酺	puy
期	qic
鲭	qky
骞	qmb
佺	qrr
穹	qsb
曲	quk
忍	rfr
瓤	rhy
爇	roc
冗	rsb
嬬	run
搔	scf
塞	sdb
涩	sed
泗	sid
蔌	suc
碎	svu
飕	szf
淘	tcd
汰	tdd
替	tif
谭	tjy
托	tof
嗵	tsk
吐	tuk
嗄	uak
沈	ufd
升	ugp
食	uir
苫	ujc
霜	uly
疏	uuv
艏	uzv
招	vcf
谪	vey
砧	vfu
吱	vik
状	vll
卓	vob
珠	vuw
咒	vzk
闻	wfm
瓮	wgg
挝	wof
五	wua
辛	xbl
夕	xip
相	xlm
嫌	xmn
箫	xnv
休	xqr
凶	xsk
削	xtx
许	xuy
讯	xyy
吖	yak
吟	ybk
爻	ycx
杨	yhm
咦	yik
腌	yjo
鹰	ykg
唷	yok
咏	ysk
竽	yuv
繇	yzv
咂	zak
兹	zib
酂	zjn
作	zor
宗	zsb

唉	aiku/
碍	aiuc/
砹	aiux/
毐	aitm/
嗳	aiky/
蔼	aicr/
霭	aiyr/
嗌	aikm/
叆	aiyy/
皑	aibj/
案	anbm/
胺	anon/
鞍	angn/
盦	anrm/
垵	antn/
犴	anqg/
𩽾	anyn/
敖	aofw/
鳌	aofy/
螯	aofi/
拗	aofl/
獒	aofq/
鏊	aofj/
鏖	aolj/
骜	aofm/
聱	aofe/
奡	aobl/
嶅	aofu/
拔	bafy/
爸	bafb/
巴	basl/
捌	bafd/
魃	bagy/
鲃	bayb/
鲅	bayy/
菝	bacy/
朳	bamb/
殡	bbdb/
濒	bbdy/
摈	bbfb/
玢	bbwf/
槟	bbmb/
抱	bcfb/
堡	bcrt/
煲	bcrh/
暴	bcou/
刨	bcbd/
褒	bcym/
胞	bcob/
葆	bccm/
苞	bccb/
鸨	bcbn/
炮	bchb/
雹	bcyb/
龅	bcvb/
趵	bczu/
掰	bduu/
捭	bdfu/
伯	bdrb/
夯	bfdl/
迸	bgzk/
榜	bhmf/
梆	bhme/
搒	bhff/
鼻	bizw/
避	bizx/
臂	biuo/
弊	bixc/
璧	biuy/
敝	bixw/
匕	bipv/
毙	bibb/
俾	biru/
鄙	bike/
吡	bikb/
弼	bigb/
痹	bibw/
妣	binb/
髀	bigu/
屄	biub/
箅	bivw/
滗	bidm/
嬖	biun/
芘	bicb/
沘	bidb/
裨	bipu/
篦	bivb/
邲	bibe/
萆	bicu/
薜	bicx/
跸	bizu/
珌	biwb/
辟	biux/
佖	birb/
荸	bicz/
筚	bivu/
佛	birf/
觱	biwy/
馝	bihb/
鲾	biyt/
坒	bibt/
拌	bjfb/
斑	bjww/
扮	bjff/
扳	bjfy/
癍	bjbw/
柈	bjmb/
攽	bjfw/
瘢	bjbu/
𨭉	bjwj/
秉	bkqr/
屏	bkuk/
槟	bkmb/
邴	bkbe/
栟	bkmk/
遍	bmzc/
辨	bmxl/
卞	bmwb/
煸	bmhc/
弁	bmsc/
辫	bmxs/
萹	bmcc/
忭	bmxb/
碥	bmuc/
𨚕	bmse/
杓	bnmu/
镳	bnjh/
骉	bnmm/
熛	bnhu/
幖	bnju/
俵	bnry/
飑	bnfb/
脿	bnoy/
拨	bofy/
搏	bofc/
勃	boul/
钵	bojb/
亳	bowq/
柏	bomb/
孛	bouz/
钹	bojy/
渤	bodl/
镈	bojc/
僰	bour/
擘	bouu/
浡	bodz/
舶	bovb/
嶓	bout/
膊	booc/
哱	bokz/
砵	boub/
踣	bozk/
簸	bovp/
菠	bocp/
鹁	boun/
檗	boum/
蕃	boct/
艴	bofb/
趵	bozu/
礴	bouc/
欂	bomc/
𬭛	bojp/
鳖	bpxy/
蹩	bpxz/
癿	bpbv/
簿	buvc/
卜	buld/
哺	bukf/
瓿	bulw/
埔	butf/
埗	butu/
𬷕	bufn/
贝	bwkr/
辈	bwfi/
邶	bwbe/
孛	bwuz/
碚	bwuk/
琲	bwwf/
惫	bwwx/
鹎	bwpn/
棓	bwmk/
椑	bwmu/
褙	bwpo/
糒	bwmy/
臂	bwuo/
鐾	bwuj/
鞁	bwgp/
糙	ccmk/
嘈	ccko/
芔	cccc/
蔡	cdcu/
彩	cdcp/
嶒	cguo/
伧	chrv/
磁	ciuy/
辞	ciux/
雌	civv/
慈	cibx/
泚	cidb/
疵	cibb/
差	ciyg/
茈	cicb/
兹	ciby/
佽	cirq/
鹚	cibn/
莿	cicd/
𫚖	civy/
残	cjdj/
粲	cjdm/
䅟	cjhp/
挫	cofr/
措	cofo/
撮	cofy/
嵯	coug/
鹾	cobg/
撺	crfi/
镩	crji/
枞	csmr/
璁	cswx/
苁	cscr/
徂	curq/
卒	cuwu/
毳	cvmm/
悴	cvxu/
漼	cvdv/
榱	cvmv/
搭	dafk/
嗒	dakk/
跶	dazd/
笪	davd/
靼	dagd/
溚	dadk/
鿎	daud/
𫟼	dajd/
纛	dcfx/
蹈	dczj/
捯	dcfd/
忉	dcxd/
舠	dcvd/
待	ddrc/
贷	ddrb/
袋	ddry/
黛	ddrh/
岱	ddru/
迨	ddzk/
呔	ddkt/
绐	ddsk/
大	ddar/
垈	ddrt/
凳	dgbj/
戥	dgog/
嶝	dgub/
菪	dhcu/
𣗋	dhmx/
笛	divy/
递	dizd/
氐	diud/
骶	digu/
邸	diue/
碲	diuj/
籴	dirm/
砥	diuu/
鞮	digz/
涤	didm/
荻	dich/
菂	dicu/
娣	dind/
诋	diyu/
柢	dimu/
杕	dimd/
坻	ditu/
踶	dizz/
媂	dinj/
提	difz/
蹢	dizg/
的	dibu/
玓	diwu/
𤧛	diwj/
𬱖	diyy/
旦	djoa/
啖	djkh/
掸	djfu/
澹	djdk/
聃	djer/
殚	djdu/
憺	djxk/
膻	djod/
疍	djzd/
瘅	djbu/
眈	djoe/
赕	djbh/
郸	djbe/
疸	djbd/
𫢸	djru/
腚	dkoz/
锭	dkjz/
啶	dkkz/
酊	dkyd/
殿	dmuu/
颠	dmuy/
掂	dmfv/
癫	dmby/
奠	dmbd/
靛	dmfz/
淀	dmdz/
癜	dmbu/
琔	dmwz/
叼	dnkd/
雕	dnkv/
貂	dnvk/
碉	dnuk/
铫	dnjv/
铞	dnjj/
汈	dndd/
朵	dojm/
铎	dojf/
踱	dozy/
咄	doki/
埵	dott/
哚	dokm/
饳	doui/
㙍	doty/
谍	dpym/
垤	dptt/
蹀	dpzm/
𫶇	dpuj/
耑	drue/
簖	drvj/
冻	dsdd/
鸫	dsdn/
硐	dsuk/
岽	dsud/
胨	dsod/
睹	duoo/
犊	dund/
椟	dumd/
渎	dudd/
阇	dumo/
厾	duvq/
黩	duld/
髑	dugi/
𬭊	dujt/
墩	dytw/
遁	dyzo/
趸	dywz/
镦	dyjw/
蹾	dyzw/
砘	dyut/
窦	dzbd/
讹	eeyb/
鳄	eeyk/
鄂	eeke/
蛾	eeiw/
颚	eeky/
轭	eeiv/
屙	eeuk/
锷	eejk/
鹗	eekn/
峨	eeuw/
萼	eeck/
垩	eeyt/
噩	eewk/
哦	eekw/
婀	eenk/
苊	eecv/
𫫇	eekx/
洱	erde/
鲕	erye/
耏	erep/
陑	eree/
垡	fart/
粪	ffmg/
焚	ffmh/
奋	ffdt/
偾	ffrb/
棻	ffcm/
棼	ffmf/
鲼	ffyb/
瀵	ffdg/
翂	ffxf/
坋	fftf/
𣸣	ffdb/
丰	fgsl/
凤	fgjy/
蜂	fgif/
沣	fgdf/
酆	fgue/
砜	fguf/
崶	fguc/
赗	fgbo/
鲂	fhyf/
肪	fhof/
牥	fhnf/
范	fjcv/
番	fjct/
帆	fjjf/
樊	fjmd/
矾	fjuf/
幡	fjjt/
燔	fjht/
氾	fjdv/
蘩	fjcx/
蹯	fjzt/
墦	fjtt/
𬸪	fjcn/
夫	fuer/
福	fupt/
父	fubx/
赋	fubv/
弗	fugl/
伏	furq/
敷	fufw/
傅	furc/
釜	fufb/
斧	fufj/
腹	fuow/
浮	fudz/
拂	fuff/
腐	fugr/
俘	furz/
腑	fuoc/
辐	fuit/
孚	fuvz/
佛	furf/
肤	fuof/
阜	fupu/
凫	funj/
祓	fupy/
芣	fucb/
鄜	fule/
涪	fudk/
黻	fuyy/
苻	fucc/
拊	fufc/
郛	fuve/
簠	fuvm/
绂	fusy/
宓	fubb/
茯	fucq/
赙	fubc/
莩	fucz/
趺	fuzf/
茀	fucf/
蝮	fuiw/
稃	fuhz/
匐	fubt/
罘	fusb/
驸	fumc/
怫	fuxf/
袱	fupq/
洑	fudq/
鲋	fuyc/
菔	fucy/
滏	fudb/
芾	fucj/
幞	fujf/
咐	fukc/
绋	fusf/
蚨	fuif/
韨	fuwy/
琈	fuwz/
垺	futz/
讣	fuyb/
蜉	fuiz/
砆	fuuf/
㕮	fukf/
㳇	fudf/
𫖯	fuvy/
肥	fwob/
斐	fwfw/
吠	fwkq/
啡	fwkf/
腓	fwof/
淝	fwdb/
蜚	fwfi/
朏	fwoi/
诽	fwyf/
翡	fwfx/
芾	fwcj/
棐	fwfm/
剕	fwfd/
𬴂	fwmf/
噶	gakr/
咖	gakk/
旮	gajo/
锆	gcjk/
郜	gcne/
槔	gcmu/
羔	gcyh/
槁	gcmk/
筶	gcvk/
钙	gdjg/
𬮿	gdej/
歌	gekq/
咯	gekk/
阁	gemk/
镉	gejg/
革	gecu/
嗝	gekg/
胳	geok/
盖	geym/
疙	gebv/
饹	geuk/
仡	gerv/
合	gerk/
虼	geiv/
塥	getg/
赓	gggb/
鲠	ggyg/
鹒	gggn/
罡	ghsv/
矼	ghug/
扛	ghfg/
冮	ghdg/
㭎	ghmx/
鿍	ghtf/
柑	gjmg/
苷	gjcg/
橄	gjmw/
酐	gjyg/
鳡	gjyx/
泔	gjdg/
坩	gjtg/
旰	gjog/
澉	gjdw/
掴	gkfy/
洸	gldg/
椁	gomz/
崞	gouz/
呙	gokn/
帼	gojy/
蜾	goig/
埚	gotn/
𬇹	gody/
冠	grbc/
贯	grmb/
毌	grml/
掼	grfb/
琯	grwl/
鳏	gryx/
筦	grvy/
涫	grdl/
莞	grcy/
鳤	gryl/
蒄	grcc/
宫	gsbk/
功	gsgl/
汞	gsgu/
贡	gsgb/
恭	gsgx/
巩	gsgf/
䢼	gsge/
硔	gsug/
蛊	guim/
咕	gukg/
瞽	guto/
菰	gucg/
辜	gugx/
毂	gutu/
觚	gudg/
酤	guyg/
锢	gujg/
崮	guug/
堌	gutg/
蛄	guig/
汩	gudo/
鹘	gugn/
牯	gung/
嘏	gugy/
鹄	gunn/
痼	gubg/
羖	guyu/
瀔	gudu/
臌	guov/
馉	guuo/
牿	gunk/
蓇	guco/
𦙶	guog/
桂	gvmt/
珪	gvwt/
邽	gvte/
鲑	gvyt/
刿	gvud/
桧	gvmy/
鳜	gvyq/
鬶	gvfg/
宄	gvbj/
皈	gvby/
炅	gvoh/
姽	gvnv/
筀	gvvt/
剐	gxkd/
鸹	gxun/
衮	gyyg/
购	gzbg/
彀	gztu/
枸	gzmj/
姤	gznk/
雊	gzjv/
句	gzbk/
笱	gzvj/
嚎	hcku/
蚝	hcim/
蒿	hcck/
毫	hcwm/
皞	hcbu/
濠	hcdu/
灏	hcdy/
鄗	hcwe/
淏	hcdt/
颢	hcoy/
嚆	hckk/
嗐	hdkk/
咳	hdkr/
何	herk/
呵	hekk/
阖	hemm/
褐	hepr/
颌	hery/
郃	here/
涸	hedg/
鹖	heon/
貉	hevk/
吓	hekx/
壑	hebt/
龢	herh/
熇	hehk/
菏	heck/
阂	hemr/
隺	hebv/
鞨	hegr/
𬌗	heyk/
珩	hgwd/
鸻	hgrn/
行	hgrd/
沆	hhdj/
汗	hjdg/
函	hjku/
焓	hjhk/
罕	hjbg/
涵	hjdu/
翰	hjux/
憾	hjxx/
瀚	hjdx/
晗	hjok/
捍	hjfg/
邗	hjge/
暵	hjot/
顸	hjgy/
撖	hjfw/
浛	hjdk/
虷	hjig/
㘎	hjkw/
崡	hjuu/
嵅	hjuk/
蔊	hjcg/
篁	hlvw/
幌	hljg/
恍	hlxg/
潢	hldb/
湟	hldw/
肓	hlwo/
锽	hljw/
惶	hlxw/
鳇	hlyw/
癀	hlbb/
蟥	hlib/
瑝	hlww/
㿠	hlbg/
𨱑	hljb/
豁	hobg/
伙	horh/
藿	hocv/
钬	hojh/
濩	hody/
夥	hogx/
嚄	hoky/
漷	hode/
劐	hocd/
佸	horu/
锪	hojx/
㸌	hohv/
欢	hryq/
涣	hrdr/
洹	hrdd/
圜	hrky/
郇	hrbe/
鲩	hryy/
宦	hrbi/
逭	hrzl/
缳	hrsy/
鹮	hrsn/
澴	hrdy/
镮	hrjy/
漶	hrdx/
痪	hrbr/
㬊	hroy/
荁	hrcd/
𤩽	hrwq/
虹	hsig/
鸿	hsdn/
泓	hsds/
吽	hskn/
訇	hsbk/
蕻	hscg/
唝	hskb/
谼	hsgg/
𬭎	hsjs/
湖	hudo/
和	huhk/
沪	hudh/
弧	hugg/
唬	hukj/
斛	hudd/
核	humr/
瑚	huwo/
瓠	hudg/
縠	hutu/
扈	huhb/
烀	huhh/
煳	huho/
惚	huxx/
鹘	hugn/
唿	hukx/
鹱	huny/
鳠	huyy/
琥	huwj/
淴	hudx/
浒	hudw/
醐	huyo/
槲	humd/
囫	hukw/
戽	huhd/
嫭	hunh/
轷	huih/
猢	huqo/
昒	huow/
喙	hvku/
慧	hvfx/
恢	hvxh/
卉	hvuc/
蕙	hvcx/
秽	hvhx/
麾	hvgm/
晦	hvom/
诲	hvym/
荟	hvcy/
浍	hvdy/
洄	hvdk/
翚	hvxi/
翙	hvux/
咴	hvkh/
珲	hvwi/
蛔	hvik/
彗	hvfe/
哕	hvkx/
诙	hvyh/
溃	hvdb/
蟪	hvix/
桧	hvmy/
烠	hvho/
硊	hvuv/
㧑	hvfw/
𬤝	hvyx/
𬭬	hvje/
华	hxru/
骅	hxmu/
觟	hxdt/
溷	hydu/
馄	hyub/
诨	hyyi/
碈	hyuo/
喉	hzku/
候	hzru/
垕	hzit/
逅	hzzk/
郈	hzie/
茬	iact/
搽	iafm/
槎	iamg/
岔	iafu/
檫	iamu/
杈	iami/
锸	iajj/
诧	iayq/
馇	iaud/
喳	iakd/
𥻗	iamd/
嘲	icko/
焯	ichu/
豺	idvc/
撤	iefw/
砗	ieui/
嗔	ifkb/
谌	ifyb/
瞋	ifob/
忱	ifxe/
煁	ifhb/
榇	ifmm/
疢	ifbh/
棽	ifmv/
郴	ifme/
程	ighw/
秤	ighp/
丞	igla/
枨	igmi/
埕	igtw/
骋	igmk/
澂	igdw/
琤	igwy/
偁	igrr/
蛏	igit/
赪	igib/
噌	igko/
酲	igyw/
柽	igmt/
瞠	igot/
珹	igwi/
晟	igoi/
铛	igje/
憕	igxb/
尝	ihxy/
昌	ihoo/
敞	ihxw/
鬯	ihkb/
怅	ihxi/
倡	ihro/
嫦	ihnj/
氅	ihxm/
伥	ihri/
鲳	ihyo/
菖	ihco/
徜	ihrk/
鲿	ihyy/
惝	ihxk/
敕	iiuw/
翅	iivx/
豉	iidv/
叱	iikb/
笞	iivk/
哧	iiki/
饬	iiul/
褫	iipj/
魑	iign/
摛	iifn/
鸱	iiun/
瘛	iibx/
漦	iiwu/
墀	iitn/
茌	iict/
眵	iiox/
篪	iivj/
傺	iiru/
踟	iizk/
胣	iioy/
痓	iibt/
搀	ijfd/
澶	ijdd/
蟾	ijik/
襜	ijpk/
谄	ijyj/
镡	ijju/
刬	ijjd/
辿	ijzu/
巉	ijut/
羼	ijuy/
廛	ijgt/
潺	ijdz/
梴	ijmv/
孱	ijuz/
骣	ijmz/
镵	ijjt/
瀍	ijdt/
冁	ijby/
搋	ikfj/
疮	ilbv/
逴	iozu/
喘	irke/
翀	isxv/
艟	isvl/
珫	iswy/
漴	isdu/
㳘	isdy/
褚	iupo/
杵	iumw/
雏	iudv/
橱	iumc/
畜	iuxt/
刍	iude/
俶	iury/
楮	iumo/
矗	iuuq/
滁	iudm/
樗	iumk/
憷	iuxz/
斶	iuji/
摴	iufk/
蜍	iuim/
濋	iudz/
蹰	iuzc/
䢺	iuie/
𬺓	iuvz/
棰	ivmt/
春	iyio/
唇	iyik/
瑃	iywo/
䲠	iyyo/
筹	izvc/
稠	izhk/
雠	izry/
俦	izrc/
椆	izmk/
犨	izrn/
踌	izzc/
侴	izrd/
金	jbrb/
今	jbrv/
尽	jbid/
锦	jbjj/
浸	jbdy/
谨	jbyw/
槿	jbmw/
襟	jbpu/
矜	jbmv/
瑨	jbwo/
噤	jbku/
溍	jbdo/
觐	jbcj/
祲	jbpy/
浕	jbdd/
荩	jbcd/
殣	jbdw/
珒	jbwy/
廑	jbgw/
琎	jbwj/
卺	jblv/
既	jigw/
鸡	jiyn/
极	jimj/
系	jipx/
继	jism/
计	jiyu/
给	jisk/
技	jifv/
击	jifk/
纪	jisj/
寂	jiby/
积	jihv/
暨	jigd/
脊	jiro/
疾	jibu/
箕	jivb/
激	jidw/
济	jidq/
叽	jikj/
饥	jiuj/
冀	jibg/
绩	jisb/
棘	jiuu/
藉	jico/
稷	jihw/
妓	jinv/
汲	jidj/
蓟	jicd/
伋	jirj/
赍	jiub/
髻	jiek/
殛	jida/
鲫	jiye/
伎	jirv/
稽	jiho/
偈	jirr/
畸	jitk/
圾	jitj/
霁	jiyq/
嫉	jinu/
讥	jiyj/
奇	jidk/
笈	jivj/
骥	jimg/
嵴	jiuo/
唧	jike/
齑	jiqj/
乩	jivv/
戢	jige/
畿	jigt/
芰	jicv/
嵇	jihu/
洎	jidz/
罽	jisd/
笄	jivk/
楫	jime/
跻	jizq/
麂	jilj/
垍	jitz/
姞	jink/
荠	jicq/
蕺	jice/
屐	jiuv/
跽	jizx/
漈	jidu/
悸	jixz/
缉	jise/
剞	jidd/
佶	jirk/
惎	jicx/
耤	jilo/
虮	jiij/
芨	jicj/
瘠	jibo/
蹐	jizo/
蒺	jicu/
墼	jiit/
鹡	jirn/
㴔	jidx/
枅	jimk/
𪟝	jifl/
𫌀	jipb/
𫓯	jijt/
𫓹	jijb/
𬯀	jieq/
𬶨	jigy/
颈	jkjy/
警	jkck/
茎	jkcj/
荆	jkcd/
竞	jklx/
菁	jkco/
晶	jkoo/
靖	jklo/
璟	jkwx/
胫	jkoj/
粳	jkmg/
劲	jkjl/
旌	jkfu/
泾	jkdj/
丼	jkjd/
竫	jkly/
儆	jkrw/
憬	jkxx/
倞	jkrx/
靓	jkfj/
鼱	jkjo/
璥	jkww/
猄	jkqx/
䴖	jkfn/
酱	jlly/
姜	jlyn/
桨	jllm/
浆	jllu/
疆	jlgj/
缰	jlsj/
鳉	jlyc/
豇	jldg/
洚	jldf/
强	jlgi/
耩	jllr/
弶	jlgx/
茳	jlcg/
煎	jmbh/
剪	jmbd/
简	jmvo/
舰	jmvj/
贱	jmbj/
健	jmry/
歼	jmdq/
荐	jmcz/
溅	jmdj/
拣	jmfd/
僭	jmro/
坚	jmlt/
鉴	jmlj/
涧	jmdo/
践	jmzj/
蹇	jmbz/
艰	jmyg/
翦	jmbx/
菅	jmcl/
俭	jmrq/
柬	jmur/
缣	jmsj/
锏	jmjo/
睑	jmoq/
鞬	jmgy/
謇	jmbk/
湔	jmdd/
踺	jmzy/
犍	jmny/
槛	jmmm/
蒹	jmcj/
搛	jmfj/
鲣	jmyt/
枧	jmmj/
鹣	jmjn/
楗	jmmy/
暕	jmoj/
谫	jmyd/
趼	jmzk/
饯	jmuj/
鞯	jmgz/
牮	jmrn/
鳒	jmyj/
胶	jnof/
浇	jndw/
绞	jnsf/
轿	jnil/
蛟	jnif/
徼	jnrf/
骄	jnml/
礁	jnuh/
饺	jnuf/
皎	jnbf/
郊	jnwe/
湫	jndh/
姣	jnnf/
酵	jnyz/
校	jnmf/
滘	jndk/
鹪	jnrn/
醮	jnyh/
皦	jnbw/
艽	jncj/
茭	jncf/
峤	jnul/
璬	jnww/
侥	jnrw/
斠	jnfd/
皭	jnbc/
藠	jncb/
噍	jnkh/
僬	jnrh/
恔	jnxf/
䴔	jnwn/
街	jprt/
戒	jpgc/
介	jprl/
捷	jpfz/
洁	jpdk/
芥	jpcj/
藉	jpco/
羯	jpyr/
颉	jpty/
桔	jpmk/
价	jprj/
疖	jpbe/
孑	jpla/
诫	jpyc/
婕	jpnz/
疥	jpbj/
碣	jpur/
絜	jpfx/
劼	jptl/
拮	jpfk/
檞	jpmn/
骱	jpgj/
湝	jpdb/
楷	jpmb/
蜐	jpil/
鲒	jpyk/
讦	jpyg/
喈	jpkb/
悈	jpxc/
岊	jpbu/
㛃	jpfn/
鸠	jqjn/
韭	jqfa/
舅	jqjl/
咎	jqwk/
臼	jqpa/
鹫	jqwn/
疚	jqbj/
氿	jqdj/
阄	jqmd/
桕	jqmj/
隽	jrrn/
鹃	jrkn/
眷	jrjo/
锩	jrjv/
桊	jrjm/
扃	jshk/
颎	jsby/
掘	jtfi/
角	jtdy/
玦	jtwg/
噘	jtkq/
攫	jtfy/
谲	jtyk/
抉	jtfg/
傕	jtrv/
桷	jtmy/
觖	jtdg/
獗	jtqq/
劂	jtid/
砄	jtug/
㵐	jtdq/
𫔎	jtjk/
𫘝	jtmg/
局	juuk/
居	juug/
拒	jufj/
狙	juqq/
钜	jujj/
矩	juuj/
遽	juzu/
莒	juck/
掬	jufm/
驹	jumj/
踞	juzg/
桔	jumk/
锔	jujk/
苴	jucq/
炬	juhj/
咀	jukq/
椐	jumg/
鞫	jugk/
屦	juun/
倨	jurg/
雎	juqv/
苣	jucj/
疽	jubq/
榉	jumf/
飓	jufb/
窭	jubn/
醵	juyu/
龃	juvq/
泃	judj/
砠	juuq/
踽	juzy/
犋	junb/
澽	judu/
弆	juqc/
䴗	juon/
𬶋	juyj/
价	jxrj/
佳	jxrt/
伽	jxrk/
驾	jxlm/
痂	jxbk/
镓	jxju/
颊	jxjy/
葭	jxcy/
郏	jxje/
瘕	jxby/
铗	jxjj/
戛	jxbg/
茄	jxck/
胛	jxoj/
槚	jxmb/
跏	jxzk/
袈	jxly/
泇	jxdk/
𬂩	jxmj/
郡	jyye/
麇	jylh/
皲	jybp/
莙	jyck/
龟	jydd/
隽	jyrn/
葰	jycw/
鲪	jyyk/
䐃	jyoh/
咖	kakk/
咔	kakb/
㸆	kchf/
锎	kdjk/
慨	kdxw/
闿	kdmj/
锴	kdjb/
忾	kdxq/
剀	kdud/
嗑	kekm/
珂	kewk/
棵	kemg/
颏	kewy/
窠	kebg/
髁	kegg/
疴	kebk/
坷	ketk/
蝌	keid/
炣	kehk/
岢	keuk/
溘	kedm/
稞	kehg/
匼	kekk/
恳	kfgx/
闶	khmj/
堪	kjtb/
龛	kjrl/
阚	kjmw/
戡	kjcg/
莰	kjcq/
衎	kjrg/
崁	kjuq/
嵁	kjub/
墈	kjtl/
磡	kjul/
郐	kkre/
侩	kkry/
匡	klkw/
诳	klyw/
眶	klow/
夼	kldi/
洭	kldw/
硿	ksug/
骷	kugg/
夔	kvbw/
溃	kvdb/
馈	kvub/
愦	kvxb/
骙	kvmt/
跬	kvzt/
悝	kvxl/
戣	kvbg/
喟	kvko/
喹	kvkt/
蒉	kvcb/
岿	kvue/
暌	kvot/
𫠆	kvvy/
堃	kyft/
鹍	kyon/
醌	kyyb/
壸	kyty/
抠	kzfq/
芤	kzcv/
喇	lakd/
落	lack/
旯	laoj/
蝲	laid/
砬	laul/
鳞	lbyf/
麟	lblf/
凛	lbdu/
璘	lbwf/
赁	lbrb/
吝	lbwk/
潾	lbdf/
粼	lbmv/
嶙	lbuf/
遴	lbzf/
瞵	lbof/
翷	lbmx/
𬴊	lbmf/
酪	lcyk/
落	lcck/
痨	lcbl/
铹	lcjl/
嫪	lcnp/
荖	lccl/
涞	lddl/
崃	ldul/
俫	ldrl/
嘞	lekl/
棱	lgmw/
堎	lgtw/
朗	lhlo/
榔	lhme/
桹	lhml/
塱	lhlt/
蒗	lhcl/
稂	lhhl/
㮾	lhlm/
蓢	lhco/
立	liwb/
理	liwl/
粒	liml/
梨	lihm/
黎	lihu/
戾	lihq/
藜	licu/
厘	liil/
犁	lihn/
笠	livl/
璃	liwn/
厉	liiw/
隶	liyu/
骊	limd/
荔	licl/
俪	lird/
醴	liyb/
砺	liuw/
澧	lidb/
鬲	lial/
罹	lisv/
疠	libw/
俚	lirl/
喱	likl/
篱	livn/
漓	lidn/
浬	lidl/
蓠	licn/
蠡	lihi/
唳	likq/
溧	lidm/
蜊	liid/
鲡	liyd/
醨	liyn/
粝	limw/
鹂	liln/
黧	lihh/
缡	lisn/
傈	lirm/
疬	libl/
跞	lizl/
浰	lidd/
雳	liyl/
猁	liqd/
篥	livm/
㰀	limu/
𫵷	liul/
拦	ljfl/
澜	ljdj/
榄	ljmj/
婪	ljmn/
罱	ljsg/
襕	ljpj/
漤	ljdn/
𬒗	ljuj/
陵	lkew/
翎	lkrx/
聆	lkes/
泠	lkds/
伶	lkrs/
苓	lkcs/
羚	lkys/
呤	lkks/
瓴	lkrw/
鲮	lkyw/
舲	lkvs/
棱	lkmw/
酃	lkye/
柃	lkms/
〇	lkvv/
鸰	lkrn/
凉	lldx/
良	lldg/
粱	lldm/
椋	llmx/
俍	llrl/
辌	llix/
𬜯	llcl/
镰	lmjj/
濂	lmdj/
殓	lmdq/
琏	lmwi/
蔹	lmcw/
潋	lmdw/
梿	lmmi/
浰	lmdd/
裣	lmpq/
瑓	lmwj/
𬶠	lmyj/
撂	lnfk/
疗	lnbl/
髎	lngp/
寥	lnbp/
橑	lnmx/
镣	lnjx/
蹽	lnzx/
漻	lndp/
鹩	lndn/
咯	lokk/
啰	lokx/
骡	lomx/
萝	locx/
雒	lowv/
蠃	lowi/
泺	lodl/
荦	locn/
漯	lodx/
捋	lofc/
蓏	locg/
裂	lpdy/
洌	lpdd/
趔	lptd/
峛	lpud/
䴕	lpdn/
刘	lqwd/
琉	lqwi/
浏	lqdd/
榴	lqmt/
鎏	lqdj/
馏	lqut/
镏	lqjt/
锍	lqji/
珋	lqwe/
罶	lqst/
瑬	lqdy/
飗	lqft/
碌	lquu/
鹠	lqpn/
栾	lrwm/
銮	lrwj/
峦	lrwu/
娈	lrwn/
脔	lrwr/
孪	lrwz/
陇	lsel/
垄	lslt/
砻	lslu/
哢	lskc/
窿	lsbu/
昽	lsol/
弄	lswc/
漋	lsdu/
𬕂	lsvb/
䂮	ltfu/
陆	luej/
露	luyk/
卤	lubx/
虏	luhl/
掳	lufl/
庐	lugh/
橹	lumo/
颅	luby/
泸	ludu/
赂	lubk/
鲈	luyu/
菉	lucu/
蕗	luck/
漉	ludl/
栌	lumu/
箓	luvu/
琭	luwu/
辘	luil/
逯	luzu/
鸬	lubn/
甪	lupy/
轳	luiu/
勠	luxl/
澛	ludo/
稑	luht/
𬬻	luju/
捋	lvfc/
履	lvuw/
缕	lvsn/
侣	lvrk/
闾	lvmk/
膂	lvfo/
偻	lvrn/
稆	lvhk/
罍	lwtf/
诔	lwyl/
酹	lwyc/
耒	lwfm/
缧	lwsx/
藟	lwct/
礌	lwut/
仑	lyrb/
溇	lzdn/
剅	lzdd/
𦝼	lzon/
蟆	maid/
摩	magu/
闵	mbmw/
愍	mbmx/
湣	mbdo/
鳘	mbpy/
黾	mbkd/
忞	mbwx/
锚	mcjt/
卯	mcpe/
茂	mccw/
昴	mcoe/
峁	mcue/
铆	mcje/
懋	mcmx/
芼	mccm/
茆	mcce/
袤	mcym/
瞀	mcmo/
眊	mcom/
蝥	mcmi/
懑	mfdx/
蒙	mgcu/
獴	mgqu/
勐	mgzl/
蠓	mgiu/
甍	mgcw/
朦	mgou/
瞢	mgco/
幪	mgju/
艨	mgvu/
蜢	mgim/
㠓	mguu/
鹲	mgcn/
芒	mhcw/
氓	mhwm/
邙	mhwe/
牤	mhnw/
厖	mhip/
蜜	mibi/
幂	mibj/
芈	micf/
靡	migf/
糜	migm/
醚	miym/
祢	mipx/
弭	mige/
汨	mido/
宓	mibb/
脒	miom/
蓂	micl/
縻	migx/
洣	midm/
嘧	miku/
漫	mjdy/
瞒	mjol/
谩	mjyy/
镘	mjjy/
颟	mjcy/
埋	mjtl/
𬜬	mjck/
暝	mkol/
溟	mkdl/
绵	mmsj/
勉	mmdl/
冕	mmoe/
沔	mmdg/
眄	mmog/
勔	mmml/
湎	mmdm/
腼	mmom/
渑	mmdd/
眇	mnou/
藐	mnce/
缪	mnsp/
鹋	mncn/
磨	mogu/
抹	mofw/
麽	mogm/
默	molq/
沫	modw/
摹	mocu/
殁	modu/
茉	mocw/
漠	modd/
貊	movb/
蓦	mocm/
瘼	mobd/
耱	molu/
无	moay/
脉	mooy/
嫫	mond/
靺	mogw/
篾	mpvd/
牧	munw/
暮	muco/
模	mumd/
慕	mucx/
幕	mucj/
募	mucl/
牡	munt/
呒	mukw/
毪	mumn/
𬭁	mujm/
酶	mwym/
梅	mwmm/
媚	mwno/
媒	mwnm/
镅	mwjo/
郿	mwue/
浼	mwde/
袂	mwpg/
楣	mwmo/
鹛	mwun/
渼	mwdd/
瑂	mwwo/
糜	mwgm/
媄	mwnd/
嵋	mwuo/
缪	mzsp/
呐	nakn/
镎	naju/
臑	ncoe/
峱	ncqu/
艿	ndcn/
鼐	ndno/
耏	ndep/
呢	nikb/
溺	nidg/
睨	nioe/
伲	nirb/
鲵	niye/
旎	nifb/
囡	njkn/
蝻	njig/
甯	nkby/
泞	nkdd/
捻	nmfx/
辇	nmfi/
拈	nmfv/
廿	nmca/
鲇	nmyv/
搦	nofg/
镊	npjy/
颞	npey/
臬	npzm/
蘖	npcm/
嗫	npky/
菍	npcx/
陧	npet/
拗	nqfl/
努	nunl/
奴	nuny/
驽	nunm/
孥	nunz/
砮	nunu/
胬	nunr/
区	oukx/
殴	ouqu/
瓯	ouqw/
𠙶	oukl/
舥	pavb/
颦	pbvu/
牝	pbnb/
姘	pbnk/
匏	pcdb/
疱	pcbb/
湃	pddf/
徘	pdrf/
砰	pgup/
硼	pguo/
朋	pgoo/
膨	pgop/
芃	pgcf/
椪	pgmy/
堋	pgto/
淜	pgdo/
搒	pgff/
鳑	phyf/
膀	phof/
劈	piud/
匹	pike/
辟	piux/
丕	piba/
疲	pibp/
痞	pibk/
坯	pitp/
嚭	pitk/
譬	piuk/
噼	pikx/
圮	pitj/
邳	pibe/
郫	pipe/
伾	pirp/
裨	pipu/
鼙	pitu/
陴	pieu/
甓	piuw/
睥	piou/
澼	pidx/
枇	pimb/
砒	piub/
蚍	piib/
纰	pisb/
仳	pirb/
鲏	piyp/
䴙	piun/
𬳵	pimp/
叛	pjby/
磐	pjvu/
槃	pjvm/
泮	pjdb/
襻	pjpu/
胖	pjob/
苹	pkcp/
鲆	pkyp/
俜	pkrk/
洴	pkdk/
泙	pkdp/
荓	pkck/
骈	pmmk/
便	pmrg/
楩	pmmg/
扁	pmhc/
㛹	pmng/
瓢	pnxg/
剽	pnxd/
朴	pnmb/
殍	pndz/
蔈	pncu/
婆	podn/
钷	pojk/
泊	podb/
皤	pobt/
桲	pomz/
繁	popx/
朴	pomb/
䥽	pojy/
蒲	pucf/
濮	pudf/
溥	pudc/
瀑	pudu/
圃	pukf/
镤	pujf/
镨	pujo/
堡	purt/
菩	puck/
匍	pubf/
潽	pudo/
脯	puof/
墣	putf/
氆	pumo/
旆	pwfj/
帔	pwjp/
霈	pwyj/
抔	pzfb/
禽	qbrn/
衾	qbry/
芹	qbcj/
溱	qbdh/
嗪	qbkh/
芩	qbcv/
揿	qbfq/
梣	qbmv/
慬	qbxw/
螓	qbih/
锓	qbjy/
檎	qbmn/
吣	qbkx/
棋	qimb/
漆	qidu/
弃	qiwc/
欺	qicq/
岂	qiuj/
砌	qiud/
琪	qiwb/
契	qifd/
淇	qidb/
泣	qidl/
琦	qiwk/
栖	qimx/
乞	qipv/
祁	qipe/
戚	qiwx/
祇	qipu/
炁	qiwh/
汽	qidq/
柒	qidm/
沏	qidd/
祈	qipj/
祺	qipb/
讫	qiyv/
岐	qiuv/
蕲	qicj/
崎	qiuk/
杞	qimj/
萁	qicb/
嘁	qikx/
凄	qidn/
碛	qiub/
畦	qitt/
綦	qicx/
亓	qiaw/
耆	qilo/
玘	qiwj/
埼	qitk/
憩	qiux/
跂	qizv/
芪	qicu/
棨	qihm/
葺	qice/
蹊	qizd/
颀	qijy/
汔	qidv/
圻	qitj/
磜	qiuu/
萋	qicn/
蛴	qiiq/
亟	qila/
俟	qiru/
郪	qiue/
稽	qiho/
缉	qise/
鲯	qiyb/
䓫	qick/
𨙸	qive/
𬨂	qiiu/
氰	qkqo/
罄	qktf/
蜻	qkio/
檠	qkcm/
亲	qklm/
庼	qkgy/
倩	qkro/
苘	qkck/
羟	qlyj/
锖	qljo/
樯	qlmk/
镪	qlji/
襁	qlpi/
蔃	qlci/
欠	qmdr/
铅	qmjk/
牵	qmdn/
迁	qmzq/
潜	qmdo/
嵌	qmuq/
钳	qmjg/
钤	qmjv/
芡	qmcq/
歉	qmjq/
仟	qmrq/
搴	qmbu/
谴	qmyl/
汧	qmdk/
荨	qmcc/
愆	qmrx/
佥	qmra/
椠	qmim/
褰	qmby/
悭	qmxt/
蒨	qmco/
岍	qmuk/
磏	qmuj/
纤	qmsq/
掮	qmfo/
圲	qmtq/
伣	qmrj/
𬘬	qmso/
翘	qnyx/
鞘	qngo/
樵	qnmh/
谯	qnyh/
侨	qnrl/
诮	qnyo/
橇	qnmm/
劁	qnrd/
峭	qnuo/
硚	qnul/
鞒	qngl/
雀	qnxv/
憔	qnxh/
硗	qnuw/
惬	qpxj/
郄	qpxe/
裘	qqqy/
楸	qqmh/
璆	qqwp/
遒	qqzy/
泅	qqdr/
俅	qqrq/
鼽	qqzj/
赇	qqbq/
龟	qqdd/
蚯	qqiq/
蝤	qqiy/
鹙	qqhn/
訄	qqjk/
犰	qqqj/
巯	qqji/
𨱇	qqjq/
拳	qrju/
醛	qryw/
颧	qrcy/
铨	qrjw/
痊	qrbw/
辁	qriw/
棬	qrmv/
鳈	qryu/
邛	qsge/
銎	qsgj/
䓖	qscl/
榷	qtmv/
阕	qtmt/
碏	qtuo/
埆	qtty/
𬒈	qtxu/
娶	quen/
趋	qute/
躯	quuq/
蘧	qucu/
袪	qupq/
胠	quoq/
朐	quoj/
劬	qujl/
阒	qumq/
苣	qucj/
戌	quwa/
鸲	qujn/
焌	quhw/
蠼	quiy/
氍	quom/
坥	qutq/
灈	qudv/
蛐	quiq/
磲	quum/
竘	qulj/
䓛	quci/
拤	qxfb/
仁	rfre/
衽	rfpw/
仞	rfrr/
讱	rfyr/
纴	rfsw/
荏	rfcw/
蒻	rocg/
鄀	roce/
戎	rsgu/
蓉	rscg/
茸	rsce/
濡	rude/
褥	rupc/
襦	rupe/
蓐	rucc/
洳	rudk/
蠕	ruie/
溽	rudc/
薷	ruce/
芮	rvcn/
蕤	rvcu/
糅	rzmm/
潵	sadw/
挲	sadu/
璱	sewb/
颡	shyy/
思	sitx/
嗣	sikk/
巳	sikv/
嘶	sikj/
俟	siru/
笥	sivk/
汜	sids/
咝	siks/
伺	sirk/
鸶	sisn/
涘	sidu/
缌	sisx/
澌	sidj/
蛳	siij/
飔	sifx/
㟃	siuk/
楒	simx/
毵	sjsm/
唆	sokw/
溹	sodx/
葰	socw/
唢	sokb/
嗍	soko/
莎	socu/
挲	sodu/
桫	somu/
耸	ssre/
嵩	ssuk/
讼	ssyg/
凇	ssdg/
𪨊	ssur/
忪	ssxg/
诉	suyi/
肃	suyb/
稣	suyh/
谡	suyw/
愫	suxx/
涑	sudu/
窣	subu/
傃	surx/
鹔	suyn/
蹜	suzb/
僳	surm/
隋	sveo/
燧	svhu/
尿	svuu/
隧	sveu/
邃	svzu/
眭	svot/
𫟦	sviu/
嗽	szkq/
蒐	szcg/
嗾	szku/
擞	szfw/
锼	szjy/
塌	tatx/
拓	tafu/
牠	tany/
趿	tazj/
闼	tamd/
蹋	tazx/
阘	tamx/
褟	tapx/
鿎	taud/
涛	tcdc/
洮	tcdv/
滔	tcdj/
焘	tcfh/
梼	tcmc/
叨	tckd/
绹	tcsf/
啕	tckf/
𫘦	tcmf/
肽	tdot/
邰	tdse/
薹	tdct/
酞	tdyt/
炱	tdsh/
滕	tgou/
縢	tgox/
螣	tgoi/
䲢	tgoy/
烫	thdh/
棠	thxm/
淌	thdk/
塘	thtk/
樘	thmt/
傥	thrx/
镋	thjx/
螗	thik/
鄌	thge/
铴	thjp/
䣘	thxe/
剔	tiod/
蹄	tizj/
惕	tixw/
嚏	tikz/
鹈	tibn/
擿	tifg/
绨	tisd/
荑	ticy/
倜	tirk/
逖	tizh/
鳀	tiyz/
𫘨	timz/
探	tjfm/
坦	tjtd/
炭	tjuh/
毯	tjmh/
瘫	tjbv/
潭	tjdu/
镡	tjju/
惔	tjxh/
忐	tjux/
倓	tjrh/
澹	tjdk/
锬	tjjh/
榃	tjmt/
磹	tjuu/
珽	tkww/
渟	tkdd/
蜓	tkiw/
莛	tkcw/
桯	tkmw/
颋	tkzy/
侹	tkrw/
烶	tkhw/
舔	tmux/
忝	tmtx/
湉	tmdu/
殄	tmdp/
沺	tmdt/
畋	tmtw/
淟	tmdb/
晪	tmob/
盷	tmoy/
蜩	tnik/
眺	tnov/
鲦	tnym/
迢	tnzk/
龆	tnvk/
驮	tomd/
拓	tofu/
侂	torq/
鼍	tokd/
椭	tomo/
柁	tomb/
箨	tovf/
柝	tomi/
圫	totq/
庹	togi/
𬶍	toyb/
帖	tpjv/
煓	trhe/
桐	tsmk/
僮	tsrl/
仝	tsrg/
潼	tsdl/
烔	tshk/
橦	tsml/
洞	tsdk/
峒	tsuk/
曈	tsol/
哃	tskk/
鲖	tsyk/
峂	tsud/
𦒍	tslx/
兔	tudd/
屠	tuuo/
菟	tuct/
凃	tudm/
稌	tuhm/
葖	tucq/
𬳿	tumm/
煺	tvhg/
暾	tyow/
饨	tyut/
坉	tytt/
鲨	uady/
煞	uadh/
刹	uaxd/
唼	uakn/
挲	uadu/
稍	ucho/
劭	ucdl/
潲	ucdo/
芍	uccu/
筲	ucvo/
召	ucdk/
柖	ucmk/
折	uefj/
赦	ueiw/
奢	uedo/
佘	ueru/
歙	uerq/
畲	uert/
滠	uedy/
厍	ueii/
拾	uefk/
猞	ueqg/
𪨶	ueui/
什	ufru/
渗	ufdp/
侁	ufre/
莘	ufcx/
瘆	ufbp/
甡	ufuu/
谌	ufyb/
椹	ufmb/
矧	uful/
呻	ufku/
绅	ufsu/
谂	ufyx/
胂	ufou/
葚	ufcb/
鲹	ufyp/
娠	ufni/
棽	ufmv/
𬳽	ufme/
昇	ugoc/
晟	ugoi/
甥	ugul/
眚	uguo/
乘	ugqr/
嵊	ugur/
赏	uhxb/
裳	uhxy/
觞	uhdp/
垧	uhtk/
诗	uiyc/
石	uiak/
试	uiyg/
饰	uiuj/
实	uibd/
氏	uipv/
士	uiua/
施	uify/
失	uipf/
尸	uikp/
识	uiyv/
矢	uipd/
嗜	uiko/
谥	uiym/
誓	uifk/
释	uicf/
恃	uixc/
仕	uirt/
侍	uirc/
逝	uizj/
豕	uiau/
蚀	uiui/
噬	uikr/
匙	uiob/
拭	uifg/
祏	uipu/
奭	uidb/
莳	uicc/
驶	uimu/
似	uirr/
舐	uiuu/
筮	uivr/
湜	uidz/
栻	uimg/
螫	uiii/
贳	uiub/
蓍	uico/
什	uiru/
酾	uiyd/
媞	uinz/
鼫	uiju/
鸤	uiun/
嘘	uiky/
鲺	uiyi/
殖	uidq/
峙	uiuc/
襫	uipb/
浉	uidj/
埘	uitc/
䏡	uiou/
䴓	uibn/
𫚕	uiyj/
𬤊	uiyz/
杉	ujmp/
煽	ujhx/
膻	ujod/
骟	ujmx/
赡	ujbk/
讪	ujyu/
禅	ujpu/
剡	ujhd/
鳝	ujyk/
鄯	ujye/
芟	ujcu/
姗	ujnc/
晱	ujoh/
潸	ujdo/
烻	ujhv/
单	ujbu/
栅	ujmc/
墡	ujtk/
𫮃	ujtu/
衰	ukyv/
泷	uldl/
鹴	ulyn/
漴	uldu/
槊	uonm/
妁	uonu/
闩	urma/
树	uumc/
术	uumd/
叔	uuuy/
梳	uumi/
孰	uuww/
署	uuso/
塾	uuwt/
恕	uunx/
庶	uugh/
戍	uuwd/
漱	uudq/
殊	uudw/
殳	uujy/
曙	uuoo/
枢	uumq/
菽	uucy/
蔬	uuci/
澍	uudc/
倏	uurq/
墅	uult/
腧	uuod/
摅	uufx/
纾	uusy/
秫	uuhu/
沭	uudu/
婌	uuny/
陎	uuew/
毹	uurm/
鄃	uure/
𬬸	uuju/
说	uvyx/
瘦	uzby/
守	uzbc/
兽	uzbk/
授	uzfy/
札	vamv/
闸	vamj/
栅	vamc/
咤	vakq/
揸	vafd/
鲊	vayv/
楂	vamd/
喳	vakd/
霅	vayk/
拃	vafv/
咋	vakv/
溠	vadg/
哳	vakj/
奓	vadx/
蚱	vaiv/
馇	vaud/
挓	vafq/
喋	vakm/
䃎	vaux/
鲝	vayy/
昭	vcok/
着	vcyo/
沼	vcdk/
曌	vcog/
旐	vcfv/
𬬿	vcjk/
𬶐	vcyv/
宅	vdbq/
寨	vdbm/
祭	vdxu/
择	vdff/
瘵	vdbu/
哲	vefk/
蛰	vefi/
辙	veiw/
赭	veio/
晢	vefo/
詟	velk/
䗪	vegi/
帧	vfjb/
针	vfju/
诊	vfyp/
鸩	vfbn/
赈	vfbi/
疹	vfbp/
榛	vfmh/
桢	vfmb/
胗	vfop/
畛	vftp/
禛	vfpb/
鬒	vfeb/
瑧	vfwh/
葴	vfck/
蓁	vfch/
揕	vffb/
袗	vfpp/
纼	vfsl/
郑	vgbe/
筝	vgvy/
铮	vgjy/
拯	vgfi/
峥	vguy/
诤	vgyy/
彰	vhlp/
鄣	vhle/
瘴	vhbu/
漳	vhdu/
樟	vhmu/
幛	vhju/
仉	vhrj/
暲	vhou/
知	viuk/
治	vidk/
支	viuy/
致	vigw/
汁	vidu/
置	visq/
智	viuo/
执	vifw/
掷	vife/
织	visv/
植	vimq/
跖	vizu/
滞	vidj/
秩	vihf/
旨	vibo/
侄	virt/
徵	virw/
栀	vimv/
芷	vicv/
址	vitv/
雉	viuv/
窒	vibt/
肢	viov/
陟	vieu/
痔	vibc/
沚	vidv/
栉	vime/
稚	vihv/
卮	viiv/
挚	vifu/
郅	vige/
殖	vidq/
畤	vitc/
峙	viuc/
絷	vifx/
摭	vifh/
蛭	viit/
鸷	vifn/
铚	vijt/
蜘	viik/
踬	vizb/
祉	vipv/
埴	vitq/
帜	vijv/
豸	vipp/
贽	vifb/
锧	vijb/
骘	viem/
踯	vize/
桎	vimt/
滍	vidi/
黹	viyx/
跱	vizc/
忮	vixv/
稙	vihq/
疐	viuz/
识	viyv/
禔	vipz/
胝	viou/
晊	viot/
庤	vigc/
梽	vimx/
榰	vimo/
𬃊	vimb/
詹	vjdk/
栈	vjmj/
毡	vjmv/
湛	vjdb/
辗	vjiy/
飐	vjfv/
崭	vjuj/
栴	vjmd/
谵	vjyk/
搌	vjfy/
𫗴	vjud/
妆	vlln/
壮	vllt/
戆	vllx/
拙	vofi/
酌	voyu/
叕	voyy/
擢	vofv/
濯	vodv/
焯	vohu/
涿	vodu/
浞	vodz/
棁	vomx/
䓬	vocu/
䦃	vojo/
𬸦	vofn/
馔	vrug/
颛	vruy/
僎	vrrg/
仲	vsrv/
盅	vsvm/
锺	vsjv/
舯	vsvv/
朱	vupw/
助	vuql/
驻	vumv/
诛	vuyw/
株	vumw/
渚	vudo/
箸	vuvo/
邾	vupe/
铢	vujw/
蛀	vuiv/
洙	vudw/
炷	vuhv/
茱	vucw/
竺	vuve/
伫	vurv/
苎	vucv/
麈	vulv/
槠	vumo/
舳	vuvy/
疰	vubv/
杼	vumy/
侏	vurw/
翥	vulx/
柷	vumx/
躅	vuzi/
蠋	vuii/
橥	vuqm/
术	vumd/
瘃	vubu/
𬣞	vuyv/
骓	vvmv/
缒	vvsl/
洲	vzdv/
皱	vzdp/
昼	vzid/
酎	vzyc/
诌	vzye/
绉	vzse/
辀	vziv/
啁	vzkk/
鸼	vzvn/
赒	vzbk/
妯	vzny/
娲	wann/
畖	watg/
玟	wfww/
汶	wfdw/
炆	wfhw/
辒	wfim/
刎	wfwd/
阌	wfmy/
紊	wfwx/
榅	wfmm/
芠	wfcw/
鳁	wfym/
𫘜	wfmw/
蕹	wgcv/
鹟	wggn/
忘	whwx/
亡	whwv/
妄	whwn/
罔	whkw/
弯	wjwg/
腕	wjov/
剜	wjbd/
皖	wjby/
宛	wjbv/
豌	wjdv/
纨	wjsw/
莞	wjcy/
脘	wjoy/
婠	wjnl/
琬	wjwv/
芄	wjcw/
塆	wjtg/
𬇕	wjdw/
涡	wodn/
渥	wodt/
偓	wort/
蜗	woin/
硪	wouw/
涴	wodv/
误	wuyt/
乌	wupa/
唔	wukk/
雾	wuyl/
呜	wukw/
午	wupu/
兀	wuae/
巫	wugr/
务	wuwl/
恶	wuyx/
邬	wuwe/
诬	wuyr/
寤	wubk/
庑	wugw/
侮	wurm/
忤	wuxw/
鹜	wumn/
梧	wumk/
晤	wuok/
骛	wumm/
杌	wumw/
鹀	wugn/
鼯	wujk/
圬	wutk/
妩	wunw/
洿	wudk/
珷	wuwv/
芴	wucw/
鋈	wudj/
屼	wuuw/
鹉	wuyn/
珸	wuwk/
牾	wunk/
仵	wurw/
峿	wuuk/
𣲘	wudw/
微	wwrj/
喂	wwky/
伪	wwrw/
唯	wwkv/
围	wwkw/
委	wwhn/
畏	wwty/
煨	wwhy/
隈	wwey/
炜	wwhw/
慰	wwux/
尉	wwuc/
苇	wwcw/
萎	wwcn/
蔚	wwcc/
纬	wwsw/
鲔	wwyo/
玮	wwww/
渭	wwdo/
帏	wwjw/
巍	wwug/
猬	wwqo/
薳	wwcy/
鳚	wwyc/
潍	wwdv/
亹	wwwq/
偎	wwry/
闱	wwmw/
诿	wwyn/
隗	wweg/
溦	wwdj/
沩	wwdw/
硙	wwuj/
崴	wwun/
煟	wwho/
逶	wwzn/
碨	wwuy/
琟	wwwv/
峗	wwuv/
螱	wwui/
鳂	wwyy/
𬀩	wwow/
𬱟	wwdy/
𬶏	wwyv/
薪	xbcj/
欣	xbjq/
鑫	xbjj/
歆	xblq/
镡	xbju/
囟	xbpx/
伈	xbrx/
莘	xbcx/
奚	xivd/
惜	xixo/
悉	xicx/
溪	xidd/
曦	xiok/
玺	xidy/
熄	xihx/
汐	xidx/
熙	xiih/
嘻	xikk/
檄	ximw/
铣	xije/
晞	xioj/
犀	xiun/
禧	xipk/
豨	xiuj/
烯	xihj/
隰	xieh/
郤	xige/
羲	xiyk/
谿	xivg/
郗	xixe/
牺	xinx/
歙	xirq/
僖	xirk/
咥	xikt/
禊	xipd/
翕	xirx/
熹	xith/
觋	xigj/
皙	ximb/
枲	xism/
嶲	xiuk/
饩	xiuq/
醯	xiym/
憙	xitx/
唏	xikj/
舄	xijh/
浠	xidj/
舾	xivx/
蹊	xizd/
傒	xird/
螅	xiix/
肸	xiou/
屣	xiuz/
觿	xidk/
酅	xiue/
穸	xibx/
屃	xiub/
蓰	xicz/
潟	xidh/
鳛	xiyb/
裼	xipw/
鼷	xijd/
阋	xime/
绤	xisg/
樨	ximn/
爔	xihk/
粞	ximx/
巇	xiug/
俙	xirj/
菥	xicj/
恓	xixx/
饻	xiuy/
𠅤	xiwx/
𫘬	ximd/
𬭳	xijk/
形	xkkp/
兴	xkxb/
邢	xkke/
刑	xkkd/
腥	xkou/
饧	xkup/
骍	xkmx/
婞	xkng/
惺	xkxu/
荥	xkcu/
悻	xkxg/
钘	xkjk/
硎	xkud/
𫰛	xknj/
乡	xlvp/
橡	xlmu/
巷	xlgs/
湘	xldo/
祥	xlpy/
详	xlyy/
襄	xlyf/
庠	xlgy/
骧	xlmf/
瓖	xlwf/
鲞	xljy/
珦	xlwk/
葙	xlco/
𬙋	xlsf/
咸	xmwk/
限	xmeg/
献	xmuq/
陷	xmej/
衔	xmrj/
氙	xmqu/
酰	xmye/
腺	xmou/
娴	xmnm/
羡	xmyq/
霰	xmyw/
纤	xmsq/
籼	xmmu/
涎	xmdv/
岘	xmuj/
苋	xmcj/
狝	xmqx/
筅	xmve/
燹	xmuh/
洗	xmde/
暹	xmzv/
缐	xmsu/
猃	xmqq/
痫	xmbm/
伭	xmrx/
跹	xmzq/
莶	xmcq/
挦	xmfc/
孅	xmnj/
鹇	xmmn/
禒	xmpu/
㬎	xmoh/
𪾢	xmoj/
𫍯	xmyk/
𬸣	xmbn/
削	xnxd/
筱	xnvw/
骁	xnmw/
咲	xnkt/
崤	xnuo/
枵	xnmk/
啸	xnkb/
潇	xndb/
嚣	xnkk/
虓	xnjj/
淆	xndo/
皛	xnbb/
哮	xnkz/
洨	xndf/
哓	xnkw/
涍	xndz/
滧	xndw/
蟏	xnib/
敩	xnxw/
𫍲	xnyy/
邪	xpye/
卸	xpve/
挟	xpfj/
泻	xpdy/
协	xpub/
泄	xpdu/
偕	xprb/
谐	xpyb/
胁	xpob/
解	xpdn/
榭	xpmc/
楔	xpmd/
亵	xpyw/
绁	xpsu/
撷	xpfy/
絜	xpfx/
廨	xpgn/
渫	xpdm/
偰	xprd/
瀣	xpdj/
揳	xpfd/
薢	xpcn/
躞	xpzy/
榍	xpmo/
㙦	xprt/
𬹼	xpvj/
咻	xqkm/
脩	xqro/
滫	xqdo/
珛	xqwo/
馐	xqui/
鸺	xqrn/
宣	xrbd/
璇	xrwz/
渲	xrdd/
玹	xrwx/
烜	xrhd/
漩	xrdz/
瑄	xrwd/
券	xrjd/
眩	xrox/
咺	xrkd/
儇	xrry/
晅	xrod/
翾	xrsx/
琄	xrwo/
痃	xrbx/
暶	xroz/
𫍽	xryy/
𫓶	xrjo/
𫠊	xrmx/
汹	xsdx/
诇	xsyk/
谑	xtye/
茓	xtcb/
峃	xtxu/
叙	xury/
绪	xuso/
圩	xuty/
诩	xuyx/
吁	xuky/
婿	xuno/
煦	xuoh/
媭	xupn/
勖	xuol/
蓿	xucb/
盱	xuoy/
顼	xuwy/
糈	xumo/
欻	xuhq/
洫	xudm/
湑	xudo/
畜	xuxt/
醑	xuyo/
浒	xudw/
魆	xugl/
珝	xuwx/
㳚	xudd/
𦈡	xuse/
𬣙	xuyy/
匣	xxkj/
辖	xxik/
叚	xxuy/
暇	xxoy/
狎	xxqj/
硖	xxuj/
厦	xxiw/
巡	xyzv/
薰	xych/
询	xyyo/
迅	xyzu/
洵	xydo/
徇	xyro/
蕈	xycu/
浔	xydc/
郇	xybe/
鲟	xyyc/
荨	xycc/
醺	xyyh/
栒	xymo/
獯	xyqh/
汛	xydu/
噀	xykg/
浚	xydw/
𫄸	xysh/
𬍤	xywc/
𬘓	xysi/
𬩽	xyee/
哑	yaky/
鸦	yayn/
衙	yark/
轧	yaiv/
蚜	yaiy/
猰	yaqd/
琊	yawe/
砑	yauy/
讶	yayy/
揠	yafn/
堐	yatt/
隐	ybex/
殷	ybpu/
尹	ybep/
寅	ybbb/
胤	ybeo/
铟	ybjy/
洇	ybdy/
茵	ybcy/
鄞	ybce/
喑	ybko/
垠	ybtg/
窨	ybbo/
禋	ybpt/
嚚	ybkk/
訚	ybmk/
龂	ybvj/
崟	ybuj/
慭	yblx/
夤	ybxb/
溵	ybdu/
狺	ybqk/
蟫	ybiu/
吲	ybkl/
硍	ybug/
歅	ybxq/
䲟	ybye/
𬤇	ybyt/
𬮱	ybmt/
姚	ycnv/
幺	ycvs/
曜	ycov/
谣	ycyf/
遥	yczf/
吆	ycky/
窈	ycbl/
肴	ycxo/
窅	ycbo/
鹞	ycvn/
铫	ycjv/
珧	ycwv/
疟	ycbe/
靿	ycgl/
侥	ycrw/
崾	ycun/
媱	ycnf/
㙘	yctn/
野	yely/
噎	yekb/
掖	yefw/
谒	yeyr/
冶	yedk/
晔	yeou/
腋	yeow/
咽	yeky/
揶	yefe/
痒	yhby/
漾	yhdy/
佯	yhry/
烊	yhhy/
飏	yhfp/
炀	yhhp/
羕	yhyy/
疡	yhbp/
鸯	yhyn/
恙	yhyx/
咉	yhky/
意	yilx/
依	yiry/
衣	yiwy/
医	yiku/
异	yisc/
裔	yiyk/
益	yibm/
邑	yikb/
役	yiru/
夷	yiar/
疑	yibz/
倚	yirk/
忆	yixv/
遗	yizb/
议	yiyy/
噫	yikx/
奕	yiwd/
怡	yixk/
溢	yidm/
驿	yimf/
疫	yibu/
胰	yioy/
刈	yixd/
颐	yiiy/
毅	yilu/
钇	yijv/
懿	yitx/
诣	yiyo/
彝	yihc/
揖	yife/
弋	yiyd/
轶	yiif/
羿	yixc/
祎	yipw/
镒	yijm/
贻	yibk/
佚	yirf/
谊	yiyq/
燚	yihh/
弈	yiwc/
咿	yiky/
扆	yihy/
镱	yijx/
佾	yiro/
浥	yidb/
臆	yiox/
瘗	yibt/
缢	yism/
沂	yidj/
峄	yiuf/
圯	yits/
绎	yisf/
熠	yihb/
迤	yizy/
劓	yizd/
翌	yixl/
埸	yitw/
漪	yidk/
苡	yicr/
饴	yiuk/
嶷	yiuz/
屹	yiuv/
肄	yiby/
挹	yifb/
裛	yiyb/
潩	yidg/
舣	yivy/
怿	yixf/
踦	yizk/
螠	yiim/
嗌	yikm/
簃	yivx/
薏	yicx/
洢	yidy/
荑	yicy/
旖	yifk/
悒	yixb/
嫕	yinx/
鹢	yibn/
勚	yiul/
呓	yikv/
眙	yiok/
蜴	yiiw/
廙	yigg/
枍	yimk/
癔	yibx/
杙	yimy/
宧	yibi/
扅	yihx/
㑊	yirb/
𫄷	yisx/
𫖮	yiuy/
𬟁	yicn/
𬬩	yijy/
𬺈	yivk/
沿	yjdk/
颜	yjwy/
岩	yjuu/
炎	yjhh/
彦	yjwp/
阎	yjmj/
艳	yjfb/
闫	yjms/
焰	yjhj/
淹	yjdd/
晏	yjon/
雁	yjiv/
鄢	yjve/
阏	yjmd/
嫣	yjnh/
檐	yjmk/
偃	yjrn/
衍	yjrd/
砚	yjuj/
魇	yjig/
甗	yjhw/
筵	yjvv/
赝	yjib/
弇	yjrc/
湮	yjdt/
酽	yjyy/
琰	yjwh/
堰	yjtn/
郾	yjke/
滟	yjdb/
沇	yjdy/
芫	yjcy/
谚	yjyp/
黡	yjih/
胭	yjoy/
唁	yjkk/
渰	yjdc/
墕	yjth/
棪	yjmh/
戭	yjbg/
掞	yjfh/
蝘	yjin/
鼹	yjjn/
崦	yjud/
厣	yjij/
漹	yjdh/
䶮	yjlt/
觃	yjjz/
𪩘	yjuq/
𫄧	yjsv/
𬙂	yjsb/
𬸘	yjkn/
营	ykck/
嬴	ykwn/
嘤	ykkn/
瑛	ykwy/
映	ykoy/
莺	ykcn/
萤	ykci/
婴	ykbn/
莹	ykcy/
颍	ykby/
媵	ykon/
膺	ykgo/
楹	ykmm/
萦	ykcx/
荧	ykch/
罂	ykbf/
滢	ykdy/
荥	ykcu/
潆	ykdx/
蓥	ykcj/
溁	ykdm/
茔	ykct/
媖	ykny/
䓨	ykcf/
愿	yrix/
员	yrkb/
园	yrky/
渊	yrdl/
垣	yrtd/
鼋	yryd/
沅	yrdy/
媛	yrny/
掾	yrfu/
塬	yrtx/
鸳	yrxn/
嫄	yrnx/
辕	yriy/
芫	yrcy/
涴	yrdv/
垸	yrty/
蜎	yrio/
眢	yrxo/
箢	yrvv/
羱	yryx/
𫘪	yrmx/
涌	ysdy/
佣	ysry/
壅	yswt/
甬	yssy/
饔	yswg/
鄘	ysge/
澭	ysdv/
墉	ysto/
喁	yskd/
恿	yssx/
埇	ysty/
鲬	ysyy/
曰	ytka/
乐	ytpx/
樾	ytml/
哕	ytkx/
钥	ytjo/
𬸚	ytqn/
雨	yuad/
预	yuyy/
瑜	yuwd/
御	yure/
逾	yuzd/
愈	yurx/
俞	yurd/
渔	yudy/
豫	yuyu/
愚	yutx/
渝	yudd/
裕	yupg/
育	yuwo/
瘀	yubd/
浴	yudg/
彧	yuga/
鹬	yumn/
峪	yuug/
誉	yuxk/
欤	yuyq/
谕	yuyd/
榆	yumd/
鬻	yugg/
煜	yuhl/
毓	yupi/
阈	yuma/
圉	yukg/
聿	yuyg/
吁	yuky/
钰	yujy/
瑀	yuwy/
鄅	yuye/
庾	yugr/
愉	yuxd/
盂	yuym/
屿	yuuy/
迂	yuzy/
禺	yutd/
遹	yuzk/
淯	yudo/
妤	yuny/
窳	yubg/
纡	yusy/
妪	yunq/
鹆	yugn/
俣	yurt/
喁	yukd/
燠	yuhd/
雩	yuyk/
腴	yuor/
舁	yujc/
谀	yuyr/
矞	yumk/
敔	yuww/
熨	yuuh/
潏	yudk/
堉	yuto/
嵛	yuud/
圄	yukk/
艅	yuvm/
揄	yufd/
萸	yucr/
臾	yujr/
褕	yupd/
燏	yuhk/
髃	yugd/
瘐	yubr/
觎	yurj/
龉	yuvk/
尉	yuuc/
蔚	yucc/
狳	yuqm/
伛	yurq/
蝓	yuid/
蓣	yucy/
㺄	yuqd/
蕴	yycm/
昀	yyoy/
妘	yyny/
韫	yywm/
恽	yyxi/
氲	yyqm/
缊	yysm/
郓	yybe/
耘	yyly/
筼	yyvb/
沄	yydy/
纭	yysy/
涢	yydb/
员	yykb/
馧	yyhm/
𫖳	yyyy/
游	yzdz/
呦	yzkl/
友	yzuy/
鼬	yzjy/
佑	yzrk/
邮	yzye/
幼	yzyl/
酉	yzxa/
悠	yzrx/
诱	yzyn/
宥	yzbo/
鱿	yzyy/
攸	yzrw/
囿	yzko/
卣	yzbk/
侑	yzro/
铕	yzjo/
猷	yzbq/
牖	yzpf/
莠	yzcn/
羑	yzyj/
莜	yzcw/
黝	yzll/
莸	yzcy/
耰	yzlw/
槱	yzmh/
蝤	yziy/
浟	yzdw/
蝣	yziz/
匝	zakj/
拶	zafx/
遭	zczo/
燥	zchm/
躁	zczm/
唣	zckq/
𥖨	zcum/
哉	zdgk/
栽	zdgm/
灾	zdbh/
责	zefb/
咋	zekv/
箦	zevb/
赜	zeib/
舴	zevv/
甑	zgbw/
曾	zgbo/
鄫	zgbe/
罾	zgso/
综	zgsu/
䎖	zgbx/
藏	zhci/
奘	zhpd/
姿	zidn/
滋	zidy/
渍	zidb/
梓	zimx/
咨	zidk/
恣	zidx/
赀	zivb/
訾	zivk/
笫	zivd/
粢	zidm/
吱	zikv/
孳	zibz/
觜	zivy/
孜	zizw/
淄	zidt/
耔	zilz/
鼒	zico/
虸	ziiz/
锱	zijt/
鄑	ziye/
錾	zjij/
拶	zjfx/
昝	zjwo/
佐	zorg/
唑	zokr/
胙	zoov/
捽	zofu/
岞	zouv/
综	zssu/
粽	zsmu/
疭	zsbr/
枞	zsmr/
偬	zsrx/
珇	zuwq/
咀	zvkq/
鲰	zzyy/
鄹	zzee/
