## 超强3简 使用deal_super_3jian_no_conflict.py生成
啊啊啊	aaa
岙岸村	aac
暗暗地	aad
爱奥华	aah
嗷嗷冷	aal
艾安琪	aaq
按安置	aav
艾奥瓦	aaw
昂昂溪	aax
爱爱医	aay
爱不爱	aba
阿巴巴	abb
熬不到	abd
挨班儿	abe
阿爸父	abf
熬不过	abg
奥本海	abh
爱泊车	abi
阿布贾	abj
奥比克	abk
阿波罗	abl
奥巴马	abm
安瓿瓶	abp
挨不起	abq
阿比让	abr
阿巴斯	abs
按不同	abt
安不上	abu
碍不着	abv
阿波舞	abw
阿坝县	abx
爱彼迎	aby
挨板子	abz
爱词霸	acb
挨呲儿	ace
奥村春	aci
按错键	acj
按错了	acl
艾参谋	acm
安次区	acq
奥藏山	acu
暗藏着	acv
按次序	acx
昂刺鱼	acy
矮矬子	acz
爱丁堡	adb
安东村	adc
按当地	add
爱迪尔	ade
阿道夫	adf
爱的歌	adg
爱德华	adh
奥迪车	adi
埃德加	adj
阿达克	adk
按道理	adl
安定门	adm
安东尼	adn
安定片	adp
爱得起	adq
爱的人	adr
奥德赛	ads
奥迪特	adt
爱迪生	adu
哀悼者	adv
阿达娃	adw
安达信	adx
安定药	ady
阿弟仔	adz
阿尔巴	aeb
埃尔顿	aed
阿尔法	aef
埃尔金	aej
阿尔卡	aek
爱尔兰	ael
奥尔莫	aem
爱尔妮	aen
阿尔派	aep
埃尔切	aeq
爱耳日	aer
爱尔思	aes
阿尔泰	aet
阿尔山	aeu
艾尔文	aew
爱尔香	aex
阿尔兹	aez
阿凡达	afd
埃菲尔	afe
阿法狗	afg
阿富汗	afh
案犯家	afj
啊服啦	afl
奥菲曼	afm
安芬尼	afn
案发前	afq
阿芙蓉	afr
艾弗森	afs
阿凡提	aft
案发时	afu
爱抚着	afv
安福县	afx
暗反应	afy
安放在	afz
阿古柏	agb
爱国村	agc
按规定	agd
挨个儿	age
爱国法	agf
按规格	agg
爱国会	agh
按国家	agj
安哥拉	agl
啊哥们	agm
爱过你	agn
昂贵品	agp
按过去	agq
奥国人	agr
安格斯	ags
阿根廷	agt
安国市	agu
爱国者	agv
爱过我	agw
爱国心	agx
熬个夜	agy
矮个子	agz
氨磺胺	aha
暗号的	ahd
安赫尔	ahe
阿哈湖	ahh
阿含经	ahj
安魂曲	ahq
爱好者	ahv
螯合物	ahw
安化县	ahx
爱还在	ahz
爱吃啊	aia
按出来	ail
爱就爱	aja
按基本	ajb
安钧璨	ajc
安静的	ajd
安吉尔	aje
奥井枫	ajf
阿姐鼓	ajg
按计划	ajh
艾景初	aji
安监局	ajj
安居卡	ajk
安静了	ajl
安检门	ajm
阿基诺	ajn
阿桔片	ajp
凹进去	ajq
埃及人	ajr
氨基酸	ajs
氨基糖	ajt
案件时	aju
案件中	ajv
安居网	ajw
安吉县	ajx
按键音	ajy
阿吉仔	ajz
按可比	akb
爱哭的	akd
按扣儿	ake
按空格	akg
奥科查	aki
阿坎吉	akj
𩽾𩾌科	akk
奥克兰	akl
澳柯玛	akm
阿奎纳	akn
艾肯泉	akq
奥克斯	aks
阿克陶	akt
安康市	aku
安康站	akv
爱看网	akw
爱科学	akx
安科院	aky
暗刻子	akz
奥利奥	ala
阿拉伯	alb
按两次	alc
阿拉丁	ald
阿拉尔	ale
奥利弗	alf
奥利给	alg
安理会	alh
安陵君	alj
埃里克	alk
熬烂了	all
阿拉姆	alm
暗恋你	aln
艾莉欧	alo
爱乐普	alp
阿联酋	alq
阿兰若	alr
安乐死	als
阿勒泰	alt
按理说	alu
暗恋着	alv
安乐窝	alw
爱立信	alx
阿里云	aly
艾莉兹	alz
爱没爱	ama
安美波	amb
按名次	amc
澳门队	amd
埃米尔	ame
按摩法	amf
按每个	amg
奥马哈	amh
奥美嘉	amj
爱美丽	aml
阿妹妹	amm
阿玛尼	amn
艾米潘	amp
按摩器	amq
按默认	amr
阿霉素	ams
熬米汤	amt
按摩师	amu
爱慕者	amv
阿迈威	amw
阿马逊	amx
安眠药	amy
爱面子	amz
安排表	apb
安平村	apc
矮胖的	apd
安排法	apf
安排给	apg
安排好	aph
安瓢虫	api
安培计	apj
安排了	apl
按排名	apm
挨批评	app
阿帕奇	apq
爱骗人	apr
爱普生	apu
爱拍照	apv
安排下	apx
阿皮亚	apy
矮胖子	apz
安全部	aqb
安全词	aqc
安全带	aqd
安琪儿	aqe
安全法	aqf
安全感	aqg
爱琴海	aqh
安全处	aqi
安全局	aqj
安全科	aqk
安其拉	aql
安全帽	aqm
爱情鸟	aqn
爱其欧	aqo
爱情片	aqp
安全期	aqq
爱妻日	aqr
安全司	aqs
安全套	aqt
安庆市	aqu
哀求着	aqv
安全网	aqw
安全性	aqx
爱奇艺	aqy
安全组	aqz
澳人报	arb
阿如村	arc
奥瑞德	ard
安若儿	are
安仁坊	arf
黯然谷	arg
爱如火	arh
熬乳茶	ari
按人均	arj
艾瑞克	ark
艾瑞里	arl
爱人民	arm
艾瑞欧	aro
阿荣旗	arq
阿瑞斯	ars
按人头	art
安如山	aru
阿日扎	arv
安仁县	arx
安若依	ary
矮人族	arz
奥赛班	asb
暗色彩	asc
奥斯达	asd
阿萨尔	ase
艾森豪	ash
爱撒娇	asj
奥斯卡	ask
奥斯陆	asl
奥斯曼	asm
阿森纳	asn
安三胖	asp
艾思奇	asq
奥司瑞	asr
阿森松	ass
奥斯汀	ast
阿苏山	asu
埃森哲	asv
阿斯旺	asw
安塞县	asx
暗色岩	asy
爱嫂子	asz
安提阿	ata
阿土伯	atb
坳头村	atc
铵态氮	atd
熬头儿	ate
凹凸感	atg
爱同行	ath
奥拓车	ati
凹透镜	atj
阿提拉	atl
奥特曼	atm
埃特纳	atn
阿托品	atp
挨铁拳	atq
阿特苏	ats
爱挑剔	att
安徒生	atu
安图县	atx
安胎药	aty
阿土仔	atz
暗杀案	aua
爱上兵	aub
矮树丛	auc
安师大	aud
按省份	auf
按时还	auh
按市场	aui
按时间	auj
爱书狂	auk
爱上了	aul
阿诗玛	aum
爱上你	aun
爱书癖	aup
爱生气	auq
爱书人	aur
奥氏体	aut
鞍山市	auu
暗示着	auv
爱上我	auw
按顺序	aux
按手印	auy
安睡在	auz
案中案	ava
安装包	avb
安中村	avc
安置地	avd
啊这儿	ave
安装费	avf
按中国	avg
安装后	avh
安装场	avi
按直接	avj
安装了	avl
矮种马	avm
爱着你	avn
安装盘	avp
安贞桥	avq
澳洲人	avr
矮壮素	avs
爱着他	avt
安装时	avu
按这种	avv
安装完	avw
爱知县	avx
安装有	avy
安装在	avz
案外案	awa
爱卫办	awb
哎卧槽	awc
阿瓦达	awd
奥威尔	awe
爱玩滚	awg
奥委会	awh
傲无常	awi
安慰剂	awj
阿威罗	awl
爱我吗	awm
安薇娜	awn
爱网球	awq
案外人	awr
安慰赛	aws
安慰他	awt
爱玩耍	awu
安慰着	awv
艾窝窝	aww
安位薰	awx
按位与	awy
阿佤族	awz
癌细胞	axb
爱心菜	axc
矮小的	axd
艾希尔	axe
岸信夫	axf
爱心果	axg
俺喜欢	axh
凹陷处	axi
岸信介	axj
爱心卡	axk
阿修罗	axl
按项目	axm
安息年	axn
按下去	axq
安息日	axr
爱相随	axs
按系统	axt
按下述	axu
暗行者	axv
爱香味	axw
按现行	axx
按协议	axy
按现在	axz
艾叶豹	ayb
奥运村	ayc
按一定	ayd
阿尤恩	aye
安逸飞	ayf
按有关	ayg
奥运会	ayh
奥运钞	ayi
凹印机	ayj
奥运卡	ayk
俺也来	ayl
爱与美	aym
挨一炮	ayp
按要求	ayq
爱牙日	ayr
奥运赛	ays
爱与痛	ayt
安阳市	ayu
按医嘱	ayv
哎哟喂	ayw
按一下	ayx
哎呀呀	ayy
暗夜紫	ayz
艾滋病	azb
肮脏的	azd
艾泽尔	aze
安葬费	azf
爱祖国	azg
安祖花	azh
爱自己	azj
阿兹卡	azk
熬走了	azl
按字母	azm
艾滋女	azn
爱自拍	azp
岸在前	azq
爱自然	azr
暗紫色	azs
鞍子山	azu
安葬着	azv
奥组委	azw
拗造型	azx
安祚永	azy
爱咋咋	azz
悲哀啊	baa
苯丙胺	bba
并保存	bbc
办不成	bbi
巴比伦	bbl
北半球	bbq
棒棒糖	bbt
半辈子	bbz
不错啊	bca
半点儿	bde
不动产	bdi
不等于	bdy
倍儿棒	beb
板儿寸	bec
博尔顿	bed
不二法	bef
巴尔干	beg
北二环	beh
丙二醇	bei
布尔津	bej
波尔卡	bek
巴尔郎	bel
鲍尔默	bem
包二奶	ben
本二批	bep
丙二醛	beq
白鹅绒	ber
伯恩斯	bes
棒儿糖	bet
百二十	beu
布尔值	bev
贝尔温	bew
板儿鞋	bex
包二爷	bey
巴尔赞	bez
不妨碍	bfa
半疯儿	bfe
包袱皮	bfp
不服气	bfq
被分为	bfw
暴风雨	bfy
并购案	bga
不归路	bgl
不高兴	bgx
不好啊	bha
不回去	bhq
绑架案	bja
不可能	bkn
报了案	bla
玻璃杯	blb
不理睬	blc
便利店	bld
布莱尔	ble
布洛芬	blf
玻璃钢	blg
不理会	blh
玻璃窗	bli
不了解	blj
不离开	blk
不聊了	bll
不礼貌	blm
不理你	bln
不赖哦	blo
舶来品	blp
保龄球	blq
被列入	blr
布鲁斯	bls
柏拉图	blt
不论是	blu
避雷针	blv
不理我	blw
不理想	blx
不利于	bly
罢免案	bma
把妹儿	bme
避免了	bml
本命年	bmn
被媒体	bmt
不能啊	bna
比年初	bni
避难所	bns
不能忘	bnw
不能再	bnz
布偶啊	boa
保平安	bpa
包片儿	bpe
不平静	bpj
背叛了	bpl
背叛你	bpn
变频器	bpq
不怕死	bps
不配套	bpt
被评为	bpw
不去啊	bqa
表情包	bqb
白千层	bqc
不确定	bqd
白求恩	bqe
版权法	bqf
不奇怪	bqg
并且还	bqh
不清楚	bqi
白切鸡	bqj
标签库	bqk
冰淇淋	bql
百千米	bqm
比去年	bqn
被欺骗	bqp
不齐全	bqq
不求人	bqr
八强赛	bqs
包青天	bqt
不全是	bqu
标签纸	bqv
八千万	bqw
被取消	bqx
不起眼	bqy
并且在	bqz
把日本	brb
不认错	brc
别人的	brd
刨刃儿	bre
不让放	brf
不如归	brg
白热化	brh
辨认出	bri
别人家	brj
被认可	brk
不入流	brl
白日梦	brm
比如你	brn
败人品	brp
哺乳期	brq
不饶人	brr
不认怂	brs
不认同	brt
比如说	bru
不认账	brv
被认为	brw
不忍心	brx
不容易	bry
被扔在	brz
比萨饼	bsb
巴松错	bsc
波塞冬	bsd
巴塞尔	bse
巴斯夫	bsf
变速杆	bsg
北三环	bsh
比赛场	bsi
本赛季	bsj
巴斯克	bsk
变色龙	bsl
波斯猫	bsm
不死鸟	bsn
被撕破	bsp
变速器	bsq
波斯人	bsr
白森森	bss
贝斯特	bst
不算数	bsu
伴随着	bsv
波斯湾	bsw
不死心	bsx
把所有	bsy
卜算子	bsz
不太矮	bta
比特币	btb
不听从	btc
不同的	btd
白天鹅	bte
白头发	btf
并通过	btg
不太好	bth
不提倡	bti
不推荐	btj
不痛快	btk
别提了	btl
半透明	btm
拜托你	btn
不同品	btp
趵突泉	btq
被他人	btr
被投诉	bts
扁桃体	btt
半桶水	btu
不停止	btv
白头翁	btw
不太像	btx
不同意	bty
别太早	btz
保税区	buq
编者按	bva
不着边	bvb
把这次	bvc
不知道	bvd
本主儿	bve
辩证法	bvf
不粘锅	bvg
标准化	bvh
不支持	bvi
保证金	bvj
补助款	bvk
不住了	bvl
不知名	bvm
本周内	bvn
标志牌	bvp
不正确	bvq
班主任	bvr
本周三	bvs
不中听	bvt
不只是	bvu
标志着	bvv
包装物	bvw
标志性	bvx
不至于	bvy
不知足	bvz
不行啊	bxa
便携版	bxb
包心菜	bxc
不小的	bxd
报信儿	bxe
保险费	bxf
不想干	bxg
不喜欢	bxh
不寻常	bxi
步行街	bxj
必修课	bxk
不行了	bxl
保鲜膜	bxm
不像你	bxn
不行哦	bxo
必需品	bxp
不下去	bxq
不信任	bxr
保险丝	bxs
不相同	bxt
半小时	bxu
不限制	bxv
不希望	bxw
不小心	bxx
不需要	bxy
不想走	bxz
鼻咽癌	bya
不一般	byb
贬义词	byc
不一定	byd
白眼儿	bye
八月份	byf
不应该	byg
不一会	byh
不远处	byi
不要紧	byj
不愉快	byk
不用了	byl
不要命	bym
比翼鸟	byn
不要怕	byp
编译器	byq
不要让	byr
白岩松	bys
避孕套	byt
必要时	byu
不一致	byv
本以为	byw
不允许	byx
不一样	byy
白羊座	byz
不再爱	bza
边走边	bzb
并在此	bzc
半自动	bzd
白嘴儿	bze
煲仔饭	bzf
包租公	bzg
不在乎	bzh
不赞成	bzi
不自觉	bzj
别走开	bzk
不在了	bzl
不怎么	bzm
不再能	bzn
包租婆	bzp
不足取	bzq
不自然	bzr
并赠送	bzs
不赞同	bzt
不再是	bzu
并组织	bzv
不作为	bzw
不在线	bzx
不足以	bzy
不自在	bzz
蹭啊蹭	cac
曾爱过	cag
残奥会	cah
曹安民	cam
错阿乡	cax
采编部	cbb
从不曾	cbc
猜不到	cbd
葱白儿	cbe
猜比分	cbf
挫败感	cbg
才不会	cbh
猜不出	cbi
仓本堇	cbj
藏宝库	cbk
错不了	cbl
从表面	cbm
才不能	cbn
曹保平	cbp
擦边球	cbq
参保人	cbr
苍白色	cbs
猜不透	cbt
才不是	cbu
猜不中	cbv
操不完	cbw
慈悲心	cbx
才不要	cby
错别字	cbz
层次感	ccg
从此后	cch
此操作	ccz
藏毒案	cda
粗等号	cdh
猜得出	cdi
参得破	cdp
测定为	cdw
曹娥江	cej
曹恩齐	ceq
慈恩寺	ces
赐恩岩	cey
苍耳子	cez
曾发表	cfb
此方法	cff
存放处	cfi
才发觉	cfj
采访了	cfl
餐费票	cfp
曹凤岐	cfq
残废人	cfr
才发现	cfx
采购案	cga
崔沟村	cgc
采购单	cgd
蹿个儿	cge
财革法	cgf
从各个	cgg
采光好	cgh
曹刚川	cgi
磁光盘	cgp
参观券	cgq
茨冈人	cgr
村公所	cgs
参观团	cgt
采购网	cgw
磁感线	cgx
采购员	cgy
策划案	cha
辞活儿	che
测绘法	chf
从宏观	chg
彩虹屁	chp
蔡和森	chs
从合同	cht
词汇学	chx
擦出爱	cia
存储量	cil
曾经爱	cja
藏经阁	cjg
参考表	ckb
翠坑村	ckc
存款单	ckd
存款额	cke
参考法	ckf
操控杆	ckg
擦口红	ckh
才看出	cki
参考价	ckj
粲夸克	ckk
财会类	ckl
词库名	ckm
才可能	ckn
参考品	ckp
采矿权	ckq
存款人	ckr
蔡克嵩	cks
蹭空调	ckt
参考书	cku
参考值	ckv
财会网	ckw
参考系	ckx
才可以	cky
财会字	ckz
才来啊	cla
从来不	clb
擦了擦	clc
催泪弹	cld
侧栏儿	cle
材料费	clf
踩了个	clg
材料后	clh
草履虫	cli
从来就	clj
才离开	clk
残留量	cll
从来没	clm
从了你	cln
崔立鹏	clp
测量器	clq
村里人	clr
翠绿色	cls
沧浪亭	clt
策略上	clu
测量值	clv
残留物	clw
材料学	clx
测量仪	cly
菜篮子	clz
才明白	cmb
错没错	cmc
聪明的	cmd
藏闷儿	cme
粗面粉	cmf
采蘑菇	cmg
彩墨画	cmh
刺毛虫	cmi
搓麻将	cmj
侧面看	cmk
凑满了	cml
村民们	cmm
从明年	cmn
草莓派	cmp
催眠曲	cmq
聪明人	cmr
侧面图	cmt
催眠术	cmu
参谋长	cmv
草莓味	cmw
侧面像	cmx
从没有	cmy
草莓族	cmz
才能把	cnb
才能到	cnd
从那儿	cne
采暖费	cnf
才能够	cng
彩泥画	cnh
从年初	cni
才能进	cnj
才能看	cnk
从哪里	cnl
草泥马	cnm
苍南派	cnp
采暖期	cnq
才能让	cnr
才能使	cnu
藏匿着	cnv
才能为	cnw
苍南县	cnx
才能有	cny
藏匿在	cnz
从旁边	cpb
草坪灯	cpd
脆皮儿	cpe
菜泡饭	cpf
擦屁股	cpg
曾捧红	cph
脆皮肠	cpi
磁偏角	cpj
彩票卡	cpk
彩牌楼	cpl
词牌名	cpm
磁盘片	cpp
翠屏区	cpq
才派人	cpr
裁判所	cps
裁判团	cpt
操盘手	cpu
裁判长	cpv
彩票网	cpw
擦皮鞋	cpx
裁判员	cpy
菜铺子	cpz
存取表	cqb
曾七次	cqc
采取的	cqd
凑趣儿	cqe
催情粉	cqf
曾去过	cqg
瓷器活	cqh
菜青虫	cqi
从全局	cqj
此情况	cqk
采取了	cql
从前面	cqm
从去年	cqn
彩旗飘	cqp
从前期	cqq
从前人	cqr
此其三	cqs
从其他	cqt
才起身	cqu
曾庆祝	cqv
萃取物	cqw
措勤县	cqx
次区域	cqy
草忍村	crc
踩热锅	crg
催人老	crl
凑热闹	crn
催人跑	crp
次日起	crq
催乳素	crs
脆弱性	crx
厕所里	csl
测速器	csq
崔斯特	cst
踩踏板	ctb
曾吐槽	ctc
菜太多	ctd
蔡天凤	ctf
刺痛感	ctg
磁头号	cth
曾提出	cti
草薙剑	ctj
彩图库	ctk
餐厅里	ctl
操他妈	ctm
此图片	ctp
丛台区	ctq
才通人	ctr
草堂寺	cts
曾剃头	ctt
藏头诗	ctu
从图中	ctv
测体温	ctw
淬透性	ctx
从头越	cty
醋坛子	ctz
藏尸案	cua
挫折感	cvg
从这里	cvl
财务部	cwb
曾五次	cwc
错误的	cwd
才玩儿	cwe
蔡文丰	cwf
从外观	cwg
村委会	cwh
财务处	cwi
蔡文姬	cwj
财务科	cwk
错误率	cwl
错误码	cwm
才问你	cwn
刺猬皮	cwp
测微器	cwq
此问题	cwt
财务室	cwu
此文章	cwv
从外形	cwx
从未有	cwy
从未在	cwz
才心安	cxa
次谐波	cxb
磁性瓷	cxc
才晓得	cxd
从小儿	cxe
磁悬浮	cxf
次新股	cxg
曾先后	cxh
曹兴诚	cxi
从小就	cxj
蔡小葵	cxk
曾效力	cxl
此项目	cxm
曾许诺	cxn
促销品	cxp
曹雪芹	cxq
参选人	cxr
操心思	cxs
从系统	cxt
慈溪市	cxu
参选者	cxv
粗纤维	cxw
惨兮兮	cxx
促销员	cxy
从现在	cxz
苍蝇儿	cye
曾有过	cyg
参议会	cyh
从远处	cyi
崔英杰	cyj
崔艺娜	cyn
参与权	cyq
慈云寺	cys
参与者	cyv
操作表	czb
操作符	czf
搓澡裤	czk
村子里	czl
藏在哪	czn
从早期	czq
操纵索	czs
操作台	czt
错在我	czw
操作性	czx
多巴胺	dba
但并不	dbb
第八次	dbc
得不到	dbd
打奔儿	dbe
大部分	dbf
都不敢	dbg
都不会	dbh
打不出	dbi
等不及	dbj
打不开	dbk
大不了	dbl
蛋白酶	dbm
都不能	dbn
大比拼	dbp
对不起	dbq
担保人	dbr
对比赛	dbs
代表团	dbt
都不是	dbu
蛋白质	dbv
等部位	dbw
都必须	dbx
大本营	dby
代表作	dbz
多惨啊	dca
道道儿	dde
打电话	ddh
对得起	ddq
第二次	dec
德尔福	def
第二行	deh
第二轮	del
第二年	den
第二批	dep
第二期	deq
第二页	dey
定方案	dfa
电饭煲	dfb
地方菜	dfc
大幅度	dfd
得分儿	dfe
豆腐干	dfg
大富豪	dfh
当饭吃	dfi
豆腐浆	dfj
大方块	dfk
东风路	dfl
单方面	dfm
豆腐脑	dfn
豆腐皮	dfp
达芬奇	dfq
东方人	dfr
大放送	dfs
地方台	dft
电风扇	dfu
豆腐渣	dfv
大范围	dfw
大方向	dfx
豆腐衣	dfy
大房子	dfz
多贵啊	dga
多个品	dgp
道个歉	dgq
大公司	dgs
多好啊	dha
都会给	dhg
电话里	dhl
导火索	dhs
大肠癌	dia
大检查	dji
读卡器	dkq
对抗赛	dks
大口子	dkz
妲丽安	dla
电路板	dlb
第六次	dlc
多伦多	dld
到了儿	dle
代理费	dlf
打了个	dlg
蝶恋花	dlh
代理处	dli
第六届	dlj
德鲁克	dlk
带来了	dll
对立面	dlm
第六年	dln
第六篇	dlp
打篮球	dlq
代理人	dlr
淡蓝色	dls
第六条	dlt
代理商	dlu
顶梁柱	dlv
第六位	dlw
独立性	dlx
独立于	dly
掉链子	dlz
大棉袄	dma
动漫片	dmp
对那些	dnx
动脑子	dnz
毒品案	dpa
东坡区	dpq
第七步	dqb
第七次	dqc
多渠道	dqd
捯气儿	dqe
第七个	dqg
电气化	dqh
电器厂	dqi
躲起来	dql
多千米	dqm
短期内	dqn
荡秋千	dqq
地球人	dqr
道琼斯	dqs
大前天	dqt
地球上	dqu
第七张	dqv
第七位	dqw
地区性	dqx
大气压	dqy
兜圈子	dqz
丢人啊	dra
代入感	drg
单人床	dri
德瑞克	drk
电容器	drq
当然要	dry
第三个	dsg
第三批	dsp
到泰安	dta
跌停板	dtb
地图册	dtc
动态的	dtd
打挺儿	dte
掉头发	dtf
都提供	dtg
洞庭湖	dth
都推出	dti
大团结	dtj
答题卡	dtk
到头来	dtl
对它们	dtm
电梯内	dtn
代替品	dtp
大提琴	dtq
带头人	dtr
大提速	dts
断头台	dtt
大体上	dtu
打头阵	dtv
对台湾	dtw
独特性	dtx
等同于	dty
搭梯子	dtz
多少啊	dua
堵住啊	dva
党指挥	dvh
打我啊	dwa
第五步	dwb
第五次	dwc
第五代	dwd
爹味儿	dwe
都无法	dwf
第五个	dwg
带问号	dwh
电位差	dwi
端午节	dwj
都忘了	dwl
第五年	dwn
第五篇	dwp
定位器	dwq
戴维斯	dws
大问题	dwt
对我说	dwu
第五种	dwv
大无畏	dww
但我想	dwx
动物园	dwy
定位在	dwz
东西啊	dxa
大小便	dxb
灯芯草	dxc
典型的	dxd
店小二	dxe
东西方	dxf
胆小鬼	dxg
都喜欢	dxh
多线程	dxi
大小姐	dxj
掉下来	dxl
弟兄们	dxm
大西南	dxn
东西欧	dxo
邓小平	dxp
掉下去	dxq
对新人	dxr
单相思	dxs
低下头	dxt
大学生	dxu
对象中	dxv
定心丸	dxw
短消息	dxx
都需要	dxy
到现在	dxz
第一步	dyb
打佯儿	dye
等于零	dyl
第一批	dyp
的意思	dys
肚子疼	dzt
电子网	dzw
电子学	dzx
二阿姨	eay
二苯胺	eba
而不必	ebb
二倍的	ebd
饿不饿	ebe
而并非	ebf
二百个	ebg
而不会	ebh
二苯基	ebj
二百块	ebk
二比零	ebl
二苯醚	ebm
而不能	ebn
二部曲	ebq
二百人	ebr
饿不死	ebs
二倍体	ebt
而不是	ebu
而不只	ebv
二百万	ebw
而不需	ebx
二百元	eby
鹅鼻嘴	ebz
而此次	ecc
厄崔迪	ecd
二次方	ecf
二次根	ecg
二菜场	eci
而此刻	eck
二次曲	ecq
二次图	ect
而此时	ecu
恩赐者	ecv
二次型	ecx
二次元	ecy
二等兵	edb
二等舱	edc
嗯对对	edd
摁钉儿	ede
二等分	edf
二等功	edg
饿得慌	edh
二等车	edi
二等奖	edj
饿得快	edk
耳朵里	edl
而得名	edm
而等你	edn
耳刀旁	edp
二道区	edq
耳朵软	edr
二段跳	edt
尔东升	edu
而斗争	edv
二大王	edw
二段线	edx
而对于	edy
饿肚子	edz
鄂尔奇	eeq
而分别	efb
而奋斗	efd
恩菲尔	efe
二分法	eff
二分场	efi
二纺机	efj
而发狂	efk
二分类	efl
二伏面	efm
阿房女	efn
二府坪	efp
二分图	eft
二妃山	efu
二分钟	efv
恩氟烷	efw
二分校	efx
鹅凤营	efy
恶搞版	egb
鹅公村	egc
恶鬼道	egd
恩格尔	ege
俄国话	egh
二甘醇	egi
鹅肝酱	egj
恩格勒	egl
恶鬼们	egm
而国内	egn
鹅肝坯	egp
二工区	egq
俄国人	egr
恩格斯	egs
二锅头	egt
鹅管石	egu
而告终	egv
而高兴	egx
二个月	egy
二公子	egz
而轰动	ehd
俄亥俄	ehe
恶狠狠	ehh
二号机	ehj
耳环孔	ehk
而忽略	ehl
二化螟	ehm
二胡曲	ehq
鹅黄肉	ehr
鹅黄色	ehs
二婚头	eht
而忽视	ehu
而后者	ehv
二环外	ehw
二号线	ehx
二合一	ehy
二皇子	ehz
二程祠	eic
二叉堆	eid
儿茶酚	eif
二重根	eig
二重唱	eii
恩仇记	eij
恩仇录	eil
而出名	eim
鄂城区	eiq
二重天	eit
而产生	eiu
恩城镇	eiv
恶臭味	eiw
而出现	eix
二重奏	eiz
二甲胺	eja
二甲苯	ejb
二甲村	ejc
二季度	ejd
阿胶粉	ejf
二极管	ejg
二句话	ejh
耳机厂	eji
二甲基	ejj
阿胶块	ejk
饿极了	ejl
二甲醚	ejm
额济纳	ejn
阿胶片	ejp
颚巨人	ejr
二聚体	ejt
而减少	eju
二进制	ejv
二级网	ejw
耳机线	ejx
二级域	ejy
而就在	ejz
摁扣儿	eke
二课分	ekf
摁开关	ekg
俄喀河	ekh
鹅口疮	eki
恩昆库	ekk
蒽醌类	ekl
而苦恼	ekn
而哭泣	ekq
而克制	ekv
儿科学	ekx
二氯胺	ela
俄联邦	elb
遏蓝菜	elc
耳聋的	eld
而立法	elf
俄勒冈	elg
二里河	elh
鄂伦春	eli
二硫键	elj
厄利空	elk
饿了龙	ell
饿了么	elm
耳流脓	eln
二老婆	elp
扼流圈	elq
二两肉	elr
俄罗斯	els
二郎腿	elt
鹅卵石	elu
二里庄	elv
二郎丸	elw
恶劣性	elx
而另一	ely
二愣子	elz
鹅毛般	emb
恶魔党	emd
恶名儿	eme
二妹夫	emf
恶魔果	emg
恶魔化	emh
恶魔城	emi
二面角	emj
蛾蠓科	emk
二马路	eml
恶魔们	emm
恶魔女	emn
峨眉派	emp
而目前	emq
恶魔人	emr
二妙散	ems
俄木塘	emt
峨眉山	emu
二拇指	emv
恶魔王	emw
恶魔系	emx
而没有	emy
恶魔族	emz
二娘啊	ena
二女儿	ene
而那个	eng
二年级	enj
而你却	enq
恶女人	enr
二年制	env
而那些	enx
二娘子	enz
二批次	epc
耳旁风	epf
阿房宫	epg
二撇胡	eph
二皮脸	epl
恶婆娘	epn
恶婆婆	epp
厄普森	eps
恩平市	epu
恶评者	epv
恩平县	epx
二氢铵	eqa
而且不	eqb
而憔悴	eqc
而且都	eqd
二缺二	eqe
二千个	eqg
而且会	eqh
二驱车	eqi
二羟基	eqj
二千块	eqk
二七路	eql
而且能	eqn
而恰恰	eqq
二千人	eqr
二千岁	eqs
而其他	eqt
而且是	equ
二千万	eqw
而且有	eqy
而且在	eqz
二人转	erv
二人行	erx
二三百	esb
二三次	esc
二三个	esg
二色红	esh
二三成	esi
二三件	esj
饿死了	esl
二三年	esn
饿死人	esr
二羧酸	ess
恩斯特	est
二三十	esu
而随着	esv
而死亡	esw
二色性	esx
二三月	esy
二三子	esz
儿童部	etb
儿童村	etc
二堂弟	etd
恩桃儿	ete
儿童房	etf
而提供	etg
儿童画	eth
儿童床	eti
儿童节	etj
而痛苦	etk
儿童类	etl
儿童们	etm
儿童票	etp
而同期	etq
二堂嫂	ets
儿童团	ett
额头上	etu
儿童周	etv
儿童学	etx
儿童院	ety
而逃走	etz
二十八	eub
而生存	euc
二十多	eud
二十二	eue
二手房	euf
二十个	eug
二手货	euh
二手车	eui
二十九	euj
二十块	euk
二十六	eul
二十秒	eum
二十年	eun
二十篇	eup
二十七	euq
二十日	eur
二十三	eus
而是他	eut
而是说	euu
而是指	euv
二十五	euw
峨山县	eux
而是要	euy
二十字	euz
饿着吧	evb
而这次	evc
二中队	evd
鹅掌风	evf
二掌柜	evg
二战后	evh
二指禅	evi
二者间	evj
饿着了	evl
而著名	evm
饿着呢	evn
鹅掌楸	evq
尔朱荣	evr
鹅掌坦	evt
鄂州市	evu
二战中	evv
摁着我	evw
而这些	evx
二中院	evy
耳坠子	evz
二维表	ewb
二维的	ewd
二万个	ewg
二位好	ewh
鄂温克	ewk
而为了	ewl
二维码	ewm
二五耦	ewo
而我却	ewq
二万人	ewr
二维图	ewt
二位数	ewu
俄外长	ewv
二万五	eww
而无需	ewx
二万元	ewy
耳捂子	ewz
恶心啊	exa
鄂西北	exb
恶心的	exd
恩希尔	exe
儿媳妇	exf
恶心感	exg
恶循环	exh
而形成	exi
二星级	exj
而羞愧	exk
恶心了	exl
二校门	exm
恶性疟	exn
二仙桥	exq
恶心人	exr
恶心死	exs
恶心吐	ext
俄新社	exu
而行之	exv
俄新网	exw
二芯线	exx
二选一	exy
而现在	exz
二乙胺	eya
耳语般	eyb
而与此	eyc
而一旦	eyd
二月二	eye
二月份	eyf
耳咽管	eyg
二元化	eyh
二元醇	eyi
二乙基	eyj
而要靠	eyk
而有力	eyl
而已嘛	eym
鳄鱼皮	eyp
而引起	eyq
二亿人	eyr
二元酸	eys
鹅鸭杀	eyu
而与之	eyv
鄂豫皖	eyw
二义性	eyx
二医院	eyy
俄语组	eyz
儿子般	ezb
而在此	ezc
儿子的	ezd
二姊夫	ezf
而自豪	ezh
而做出	ezi
恶作剧	ezj
恶唑啉	ezl
而最让	ezr
恩佐斯	ezs
俄总统	ezt
而在这	ezv
儿子我	ezw
而在于	ezy
腐败案	fba
范冰冰	fbb
发布词	fbc
方便的	fbd
翻本儿	fbe
烦不烦	fbf
分布广	fbg
发布会	fbh
发不出	fbi
防暴警	fbj
分不开	fbk
分辨率	fbl
方便面	fbm
非不能	fbn
放鞭炮	fbp
分不清	fbq
发布人	fbr
福布斯	fbs
分布图	fbt
分布式	fbu
犯不着	fbv
分别为	fbw
放不下	fbx
翻白眼	fby
分别在	fbz
法草案	fca
发慈悲	fcb
分层次	fcc
犯错的	fcd
防错法	fcf
翡翠谷	fcg
风从虎	fch
翡翠城	fci
凡参加	fcj
发财卡	fck
发财了	fcl
发财梦	fcm
发财票	fcp
芳村区	fcq
发错人	fcr
非彩色	fcs
翡翠台	fct
发财树	fcu
分餐制	fcv
犯错误	fcw
讽刺性	fcx
服从于	fcy
贩毒案	fda
辅导班	fdb
发大财	fdc
肥嘟嘟	fdd
发点儿	fde
辅导费	fdf
梵蒂冈	fdg
负电荷	fdh
房地产	fdi
放大镜	fdj
辅导课	fdk
发动了	fdl
防盗门	fdm
斐迪南	fdn
反对派	fdp
放大器	fdq
房大人	fdr
防盗锁	fds
反堕胎	fdt
反倒是	fdu
反对者	fdv
防盗网	fdw
放得下	fdx
辅导员	fdy
负电子	fdz
菲尔波	feb
份儿菜	fec
富二代	fed
份儿饭	fef
伏尔甘	feg
反而会	feh
风儿吹	fei
伏尔加	fej
法尔考	fek
费尔马	fem
凡尔纳	fen
份儿钱	feq
粉蛾绒	fer
凡尔赛	fes
伏尔泰	fet
反而是	feu
发儿小	fex
非恶意	fey
反而在	fez
枫芙爱	ffa
赴港澳	fga
非货币	fhb
复合管	fhg
防护林	fhl
防火墙	fhq
凤凰山	fhu
福长安	fia
非常棒	fib
肺穿刺	fic
非常大	fid
非常饿	fie
风吹拂	fif
非常贵	fig
非常好	fih
非常差	fii
副处级	fij
非常快	fik
发出了	fil
非常慢	fim
非常难	fin
副产品	fip
非常强	fiq
非常热	fir
帆船赛	fis
非传统	fit
方程式	fiu
非常重	fiv
房产网	fiw
非常想	fix
芳城园	fiy
方程组	fiz
犯贱啊	fja
凤姐儿	fje
福康安	fka
妇科病	fkb
发刊词	fkc
防空洞	fkd
付款额	fke
封口费	fkf
反馈给	fkg
方括号	fkh
富康车	fki
封口机	fkj
反馈卡	fkk
翻开了	fkl
方可梦	fkm
福克纳	fkn
防空炮	fkp
封控区	fkq
付款人	fkr
福克斯	fks
方框图	fkt
放开手	fku
副科长	fkv
发卡网	fkw
反科学	fkx
付款用	fky
方块字	fkz
氟利昂	fla
菲律宾	flb
犯了错	flc
反垄断	fld
浮礼儿	fle
翻了翻	flf
法轮功	flg
风凉话	flh
分理处	fli
福利姬	flj
弗兰克	flk
法拉利	fll
富勒姆	flm
放了你	fln
飞利浦	flp
费力气	flq
芬兰人	flr
发牢骚	fls
服了他	flt
法律上	flu
粉连纸	flv
分裂为	flw
法兰西	flx
福利院	fly
负离子	flz
风门坳	fma
分米波	fmb
附面层	fmc
丰满的	fmd
父母恩	fme
放没放	fmf
父母官	fmg
粉煤灰	fmh
分泌出	fmi
方面军	fmj
罚没款	fmk
福美来	fml
反木马	fmm
仿玛瑙	fmn
非卖品	fmp
父母亲	fmq
发明人	fmr
法门寺	fms
飞毛腿	fmt
分明是	fmu
抚摸着	fmv
分泌物	fmw
父母心	fmx
驸马爷	fmy
非麻醉	fmz
疯牛病	fnb
反纳粹	fnc
妇女的	fnd
放那儿	fne
妇女法	fnf
放哪个	fng
非农化	fnh
丰年虫	fni
妇女节	fnj
方脑壳	fnk
父女俩	fnl
妇女们	fnm
放你那	fnn
父女情	fnq
疯女人	fnr
烦恼丝	fns
福奈特	fnt
伏牛山	fnu
烦恼障	fnv
放牛娃	fnw
阜宁县	fnx
非农业	fny
仿牛仔	fnz
霏欧纳	fon
分配表	fpb
凤坪村	fpc
扶贫点	fpd
翻篇儿	fpe
分配法	fpf
分配给	fpg
非平衡	fph
反爬虫	fpi
方片九	fpj
扶贫款	fpk
废品率	fpl
复平面	fpm
肺泡囊	fpn
范跑跑	fpp
发脾气	fpq
发盘人	fpr
方片三	fps
非普通	fpt
方片十	fpu
肥胖者	fpv
方片五	fpw
阜平县	fpx
方片一	fpy
覆盆子	fpz
放弃啊	fqa
分区表	fqb
反器材	fqc
反其道	fqd
粪球儿	fqe
富强粉	fqf
番茄谷	fqg
风情画	fqh
分清楚	fqi
番茄酱	fqj
方铅矿	fqk
放弃了	fql
防撬门	fqm
腹腔内	fqn
反犬旁	fqp
发情期	fqq
发起人	fqr
分区赛	fqs
非其他	fqt
福清市	fqu
番茄汁	fqv
废弃物	fqw
反倾销	fqx
非企业	fqy
负全责	fqz
富人榜	frb
非如此	frc
法人的	frd
法瑞尔	fre
范瑞芳	frf
法人股	frg
芙蓉花	frh
缝纫厂	fri
缝纫机	frj
佛瑞克	frk
反人类	frl
非人民	frm
非让你	frn
腐乳瓶	frp
芙蓉区	frq
腐乳肉	frr
风入松	frs
芙蓉汤	frt
芙蓉石	fru
芙蓉镇	frv
非让我	frw
发如雪	frx
疯人院	fry
非人哉	frz
放肆爱	fsa
分三步	fsb
富色彩	fsc
发送到	fsd
粉丝发	fsf
发送给	fsg
分散化	fsh
付思超	fsi
粉碎机	fsj
烦死了	fsl
粉丝们	fsm
傅斯年	fsn
分散片	fsp
分赛区	fsq
烦死人	fsr
非诉讼	fss
福斯特	fst
分散式	fsu
副所长	fsv
粉丝网	fsw
分散性	fsx
风速仪	fsy
分散在	fsz
氟他胺	fta
繁体版	ftb
繁体词	ftc
非特定	ftd
房托儿	fte
防台风	ftf
非托管	ftg
法塔赫	fth
丰田车	fti
伏特加	ftj
反坦克	ftk
沸腾了	ftl
仿桃木	ftm
芬太尼	ftn
发图片	ftp
福田区	ftq
发帖人	ftr
犯太岁	fts
发推特	ftt
发帖数	ftu
副厅长	ftv
发推文	ftw
凤台县	ftx
沸腾鱼	fty
繁体字	ftz
封住啊	fva
法制办	fvb
付庄村	fvc
发展到	fvd
放这儿	fve
反政府	fvf
发展观	fvg
法制化	fvh
发展成	fvi
发展局	fvj
法制科	fvk
非主流	fvl
辅助码	fvm
烦着呢	fvn
纺织品	fvp
发展期	fvq
副主任	fvr
腐植酸	fvs
发纸条	fvt
非正式	fvu
发展中	fvv
发展为	fvw
副主席	fvx
分之一	fvy
放置在	fvz
服务网	fww
芳香胺	fxa
放心吧	fxb
芳香醋	fxc
发祥地	fxd
发小儿	fxe
分析法	fxf
方向感	fxg
分析后	fxh
分析出	fxi
方向键	fxj
复选框	fxk
发现了	fxl
复兴门	fxm
逢小年	fxn
方向盘	fxp
反洗钱	fxq
发行人	fxr
法西斯	fxs
分析题	fxt
分析师	fxu
副校长	fxv
飞行物	fxw
非线性	fxx
飞行员	fxy
风信子	fxz
妃悠爱	fya
非一般	fyb
反义词	fyc
发源地	fyd
法约尔	fye
翻一番	fyf
发言稿	fyg
放烟花	fyh
反映出	fyi
复印件	fyj
放焰口	fyk
反映了	fyl
非移民	fym
符雅凝	fyn
非药品	fyp
发言权	fyq
发言人	fyr
飞也似	fys
菲亚特	fyt
分以上	fyu
副院长	fyv
非要我	fyw
发一下	fyx
发源于	fyy
反映在	fyz
副总裁	fzc
负罪感	fzg
肥皂剧	fzj
丰子恺	fzk
父子俩	fzl
夫子庙	fzm
肥皂泡	fzp
份子钱	fzq
负责人	fzr
副总统	fzt
分子式	fzu
复杂性	fzx
发粽子	fzz
国奥村	gac
公安法	gaf
郭爱华	gah
谷爱凌	gal
更安全	gaq
谷氨酸	gas
关爱着	gav
孤哀子	gaz
购并案	gba
根本不	gbb
广播操	gbc
怪不得	gbd
嘎巴儿	gbe
工本费	gbf
敢不敢	gbg
搞不好	gbh
搞不成	gbi
根本就	gbj
贵宾卡	gbk
改变了	gbl
各部门	gbm
更不能	gbn
盖玻片	gbp
过不去	gbq
给别人	gbr
古波斯	gbs
广播台	gbt
跟不上	gbu
高标准	gbv
各部委	gbw
根本性	gbx
个把月	gby
赶不走	gbz
光存储	gci
供参考	gck
搞错了	gcl
瓜菜仁	gcr
感到很	gdh
该地块	gdk
规定了	gdl
该地区	gdq
规定者	gdv
光电子	gdz
更方便	gfb
广泛的	gfd
顾逢恩	gfe
规范化	gfh
郭富城	gfi
鼓风机	gfj
过分了	gfl
干翻你	gfn
贵妇人	gfr
共发送	gfs
辜负他	gft
高富帅	gfu
购房者	gfv
共分为	gfw
高风险	gfx
更富有	gfy
乖乖女	ggn
广告人	ggr
盖公章	ggv
广告位	ggw
干哈啊	gha
干活儿	ghe
共和国	ghg
勾画出	ghi
郭海萍	ghp
光和热	ghr
规划委	ghw
挂号信	ghx
乖孩子	ghz
古长安	gia
工程部	gib
各车次	gic
共产党	gid
更充分	gif
该成果	gig
国产化	gih
国产车	gii
歌唱家	gij
工程款	gik
构成了	gil
光触媒	gim
刚成年	gin
各产品	gip
滚出去	giq
狗吃肉	gir
更出色	gis
工程图	git
工程师	giu
过程中	giv
广场舞	giw
工程系	gix
贯穿于	giy
广成子	giz
高技能	gjn
更可爱	gka
谷壳儿	gke
更可贵	gkg
公开化	gkh
概括了	gkl
更可能	gkn
更可怕	gkp
该课题	gkt
工控网	gkw
赶快走	gkz
过来啊	gla
管理部	glb
狗链儿	gle
管理所	gls
管理者	glv
管理员	gly
干嘛啊	gma
搞明白	gmb
灌木丛	gmc
国民党	gmd
哥们儿	gme
购买方	gmf
鬼门关	gmg
规模化	gmh
改名成	gmi
购买价	gmj
观摩课	gmk
购买了	gml
歌迷们	gmm
干嘛呢	gmn
古墓派	gmp
冠名权	gmq
郭沫若	gmr
戈麦斯	gms
各媒体	gmt
过敏史	gmu
估摸着	gmv
更名为	gmw
革命性	gmx
更没有	gmy
给面子	gmz
高尼奥	gna
功能表	gnb
狗奴才	gnc
高难度	gnd
姑娘儿	gne
国内法	gnf
概念股	gng
高能耗	gnh
概念车	gni
功能键	gnj
给你看	gnk
过年嘞	gnl
给你们	gnm
姑奶奶	gnn
骨牛排	gnp
更年期	gnq
给女人	gnr
给你扫	gns
给你听	gnt
功能上	gnu
观念中	gnv
国内外	gnw
功能性	gnx
工农业	gny
该男子	gnz
个屁阿	gpa
光盘版	gpb
高频词	gpc
供配电	gpd
歌片儿	gpe
光谱法	gpf
光屁股	gpg
搞破坏	gph
跟屁虫	gpi
挂牌价	gpj
高普考	gpk
更漂亮	gpl
瓜皮帽	gpm
购票难	gpn
更配哦	gpo
各品牌	gpp
骨盆腔	gpq
股票热	gpr
公平锁	gps
高频头	gpt
桂平市	gpu
高品质	gpv
高品位	gpw
公平性	gpx
给朋友	gpy
挂牌子	gpz
高桥爱	gqa
刚起步	gqb
高桥村	gqc
过去的	gqd
贵圈儿	gqe
过桥费	gqf
各器官	gqg
古气候	gqh
搞清楚	gqi
国庆节	gqj
钢琴课	gqk
过去了	gql
歌曲名	gqm
跟去年	gqn
钢琴谱	gqp
钢琴曲	gqq
国庆日	gqr
更轻松	gqs
共青团	gqt
感情上	gqu
光圈值	gqv
供求网	gqw
高清晰	gqx
该企业	gqy
枸杞子	gqz
果然啊	gra
果仁儿	gre
干扰器	grq
该让他	grt
各赛区	gsq
割头案	gta
改天吧	gtb
感叹词	gtc
共同点	gtd
跟趟儿	gte
过堂风	gtf
蓇葖果	gtg
感叹号	gth
钢铁厂	gti
国土局	gtj
更痛苦	gtk
改天聊	gtl
给他们	gtm
管他呢	gtn
罐头瓶	gtp
柜台前	gtq
高投入	gtr
古铜色	gts
共同体	gtt
跟他说	gtu
该同志	gtv
宫廷舞	gtw
光通信	gtx
钢铁业	gty
赶他走	gtz
干啥啊	gua
跟着爱	gva
给我啊	gwa
公文包	gwb
公务舱	gwc
更稳定	gwd
港味儿	gwe
更无法	gwf
给我滚	gwg
管委会	gwh
购物车	gwi
该文件	gwj
公务卡	gwk
跟我来	gwl
给我们	gwm
过完年	gwn
歌舞片	gwp
国务卿	gwq
高污染	gwr
歌舞厅	gwt
个位数	gwu
贵网站	gwv
购物网	gww
古文献	gwx
公务员	gwy
跟我走	gwz
古希腊	gxl
感兴趣	gxq
更希望	gxw
工业部	gyb
更优惠	gyh
公园内	gyn
工业区	gyq
共有人	gyr
广域网	gyw
赶鸭子	gyz
工作啊	gza
瓜子儿	gze
昏暗暗	haa
河岸边	hab
后安村	hac
黑暗粉	haf
很昂贵	hag
回安徽	hah
磺胺类	hal
皇阿玛	ham
很爱你	han
海岸炮	hap
很安全	haq
好爱他	hat
还爱着	hav
很爱玩	haw
海岸线	hax
磺胺药	hay
好笨啊	hba
汉堡包	hbb
很不错	hbc
恨不得	hbd
话把儿	hbe
好办法	hbf
还不够	hbg
会不会	hbh
后半场	hbi
后半句	hbj
还包括	hbk
回不来	hbl
伙伴们	hbm
还不能	hbn
很棒哦	hbo
会被喷	hbp
回不去	hbq
还不如	hbr
灰白色	hbs
好半天	hbt
还不是	hbu
还不止	hbv
花不完	hbw
还不行	hbx
很必要	hby
活靶子	hbz
华藏寺	hcs
火电厂	hdi
幻灯片	hdp
很多人	hdr
好烦啊	hfa
很发达	hfd
会费额	hfe
合法化	hfh
黄粉虫	hfi
河坊街	hfj
恢复了	hfl
红发男	hfn
护肤品	hfp
护发素	hfs
海富通	hft
合肥市	hfu
寒风中	hfv
划分为	hfw
很复杂	hfz
黑鬼啊	hga
黑格尔	hge
化工厂	hgi
合格率	hgl
昏过去	hgq
还告诉	hgs
回过神	hgu
花岗岩	hgy
好工作	hgz
很好啊	hha
红孩儿	hhe
哈哈哈	hhh
很好奇	hhq
挥挥手	hhu
合成氨	hia
何尝不	hib
合成词	hic
好吃的	hid
话茬儿	hie
红茶坊	hif
很成功	hig
黑吃黑	hih
昏沉沉	hii
好成绩	hij
黑长裤	hik
换成了	hil
很出名	him
好吹牛	hin
灰翅鸥	hio
火车票	hip
豁出去	hiq
海超人	hir
很出色	his
合唱团	hit
火车上	hiu
火车站	hiv
会成为	hiw
会出现	hix
还处于	hiy
还处在	hiz
好可爱	hka
户口本	hkb
还款额	hke
后空翻	hkf
很宽敞	hki
很快就	hkj
好卡哦	hko
很可怕	hkp
航空器	hkq
汉克斯	hks
很可恶	hkw
哈喽啊	hla
好慢啊	hma
很明白	hmb
花名册	hmc
黑名单	hmd
黑木耳	hme
很麻烦	hmf
哈密瓜	hmg
荒漠化	hmh
毫米长	hmi
护目镜	hmj
汗毛孔	hmk
花木兰	hml
灰蒙蒙	hmm
画眉鸟	hmn
号码牌	hmp
很明确	hmq
很迷人	hmr
红霉素	hms
海绵体	hmt
号码是	hmu
昏迷中	hmv
还没完	hmw
很明显	hmx
还没有	hmy
汉民族	hmz
还能爱	hna
换尿布	hnb
湖南菜	hnc
很难得	hnd
好男儿	hne
淮南方	hnf
还能够	hng
好女孩	hnh
好难吃	hni
回娘家	hnj
很难看	hnk
活腻了	hnl
和你们	hnm
喝牛奶	hnn
贺年片	hnp
很年轻	hnq
好男人	hnr
哈纳斯	hns
混凝土	hnt
很难受	hnu
还拿着	hnv
海内外	hnw
化脓性	hnx
还能用	hny
还能在	hnz
很普遍	hpb
侯佩岑	hpc
好评度	hpd
画片儿	hpe
很佩服	hpf
和平鸽	hpg
后怕虎	hph
很平常	hpi
黄浦江	hpj
含鄱口	hpk
很漂亮	hpl
海平面	hpm
害怕你	hpn
红扑扑	hpp
和平区	hpq
海普瑞	hpr
很怕死	hps
很普通	hpt
黄皮书	hpu
花盆中	hpv
琥珀屋	hpw
合浦县	hpx
好朋友	hpy
好片子	hpz
回去啊	hqa
华强北	hqb
红旗村	hqc
何其多	hqd
好气儿	hqe
还缺乏	hqf
很奇怪	hqg
回青海	hqh
很清楚	hqi
黑旗军	hqj
还欠款	hqk
回去了	hql
花钱买	hqm
胡青牛	hqn
沪青平	hqp
黑漆漆	hqq
很气人	hqr
很轻松	hqs
或其他	hqt
黄秋生	hqu
获取值	hqv
婚庆网	hqw
好奇心	hqx
或企业	hqy
后勤组	hqz
好热啊	hra
好骚啊	hsa
贺岁片	hsp
齁嗓子	hsz
好听啊	hta
很特别	htb
回头草	htc
荒唐的	htd
好天儿	hte
合同法	htf
还提供	htg
皇太后	hth
火腿肠	hti
回头见	htj
回头看	htk
滑铁卢	htl
还他妈	htm
惠特尼	htn
火腿片	htp
航天器	htq
核桃仁	htr
黄体素	hts
红彤彤	htt
红糖水	htu
合同制	htv
回头望	htw
换头像	htx
航天员	hty
皇太子	htz
好重啊	hva
好玩啊	hwa
红卫兵	hwb
恒温槽	hwc
好玩儿	hwe
会务费	hwf
和为贵	hwg
画问号	hwh
环卫处	hwi
很完美	hwm
很无奈	hwn
黄文平	hwp
核武器	hwq
化物所	hws
好文章	hwv
还问我	hww
黑屋子	hwz
化学品	hxp
很希望	hxw
还有啊	hya
黄炎培	hyp
很有趣	hyq
会议厅	hyt
后遗症	hyv
孩子啊	hza
花籽儿	hze
红棕色	hzs
海贼王	hzw
吃吧啊	iba
吃不饱	ibb
尝百草	ibc
差不多	ibd
车本儿	ibe
承包方	ibf
丑八怪	ibg
车标号	ibh
吃不吃	ibi
出版局	ibj
储备库	ibk
出不来	ibl
出必买	ibm
崇拜你	ibn
长坂坡	ibp
出不去	ibq
承包人	ibr
场比赛	ibs
崇拜他	ibt
出版社	ibu
撑不住	ibv
出版物	ibw
吃不消	ibx
出版业	iby
筹备组	ibz
储藏期	icq
尺寸为	icw
查档案	ida
差点儿	ide
车道沟	idg
吃得好	idh
吃多了	idl
陈道明	idm
超低频	idp
肠毒素	ids
吹笛子	idz
初二级	iej
成分股	ifg
查个案	iga
吃盒饭	ihf
成活率	ihl
出差啊	iia
吃鸡啊	ija
超可爱	ika
吃快餐	ikc
出口到	ikd
出口额	ike
出口国	ikg
创刊号	ikh
成克杰	ikj
出口量	ikl
长裤男	ikn
持卡人	ikr
超快速	iks
吃苦头	ikt
陈楷雯	ikw
吃空饷	ikx
出来啊	ila
处理层	ilc
茶卤儿	ile
除了你	iln
处理器	ilq
车轮锁	ils
除了他	ilt
除了我	ilw
矗立在	ilz
穿棉袄	ima
触摸板	imb
长睦村	imc
崇明岛	imd
长毛儿	ime
吃米饭	imf
称美国	img
陈慕华	imh
陈牧驰	imi
传媒界	imj
城门口	imk
充满了	iml
重命名	imm
长命女	imn
橙蜜藕	imo
触摸屏	imp
出门前	imq
出卖人	imr
长命锁	ims
长毛兔	imt
出门时	imu
充满着	imv
车迷网	imw
崇明县	imx
沉迷于	imy
成名作	imz
吹牛逼	inb
城南村	inc
处女地	ind
丑奴儿	ine
处女峰	inf
炒年糕	ing
处女航	inh
出纳处	ini
刹那间	inj
朝南开	ink
超能力	inl
处女膜	inm
纯牛奶	inn
吹牛皮	inp
长宁区	inq
成年人	inr
超浓缩	ins
出难题	int
承诺书	inu
承诺制	inv
场内外	inw
长宁县	inx
沉溺于	iny
处女座	inz
戳破啊	ipa
敞篷版	ipb
常平仓	ipc
长跑队	ipd
唱片儿	ipe
吃派饭	ipf
吃苹果	ipg
车牌号	iph
敞篷车	ipi
产品奖	ipj
成品库	ipk
成品粮	ipl
唱片名	ipm
臭皮囊	ipn
吹泡泡	ipp
昌平区	ipq
持票人	ipr
陈佩斯	ips
吃葡萄	ipt
吃偏食	ipu
车牌照	ipv
触碰我	ipw
产品线	ipx
成品油	ipy
产品组	ipz
传球啊	iqa
拆迁办	iqb
炒芹菜	iqc
重启动	iqd
岔曲儿	iqe
拆迁费	iqf
唱起歌	iqg
拆迁户	iqh
乘汽车	iqi
产权界	iqj
长期看	iqk
出去了	iql
陈其迈	iqm
厂区内	iqn
穿旗袍	iqp
吹气球	iqq
拆迁人	iqr
重庆赛	iqs
出气筒	iqt
重庆市	iqu
产权证	iqv
出去玩	iqw
长期性	iqx
场强仪	iqy
穿裙子	iqz
陈润儿	ire
传染给	irg
朝日铃	irl
炒肉丝	irs
陈思安	isa
长梯隘	ita
冲突表	itb
柴田聪	itc
畅通的	itd
尺头儿	ite
长途费	itf
床头柜	itg
出台后	ith
衬托出	iti
朝天椒	itj
赤铁矿	itk
出台了	itl
朝天门	itm
出头鸟	itn
冲天炮	itp
朝天区	itq
纯天然	itr
承天寺	its
赤条条	itt
传统上	itu
冲突中	itv
称他为	itw
长条形	itx
锄头雨	ity
吃桃子	itz
沉重啊	iva
沉重的	ivd
持支持	ivi
陈至立	ivl
撑着伞	ivs
称之为	ivw
初中组	ivz
丑闻案	iwa
超文本	iwb
吃午餐	iwc
宠物店	iwd
臭味儿	iwe
吃完饭	iwf
宠物狗	iwg
常委会	iwh
超外差	iwi
除味剂	iwj
朝外开	iwk
成为了	iwl
崇文门	iwm
宠物女	iwn
陈屋坡	iwp
崇文区	iwq
陈伟容	iwr
查韦斯	iws
出问题	iwt
窗外事	iwu
乘务长	iwv
颤巍巍	iww
常温下	iwx
乘务员	iwy
纯文字	iwz
重新爱	ixa
吃西餐	ixc
成宿儿	ixe
程序法	ixf
呈现出	ixi
陈小姐	ixj
出现了	ixl
肠系膜	ixm
城西南	ixn
扯闲篇	ixp
吃下去	ixq
除息日	ixr
长相思	ixs
扯闲天	ixt
畅销书	ixu
陈锡文	ixw
创新性	ixx
程序员	ixy
臭小子	ixz
陈元安	iya
穿衣服	iyf
超越了	iyl
朝阳区	iyq
出洋相	iyx
赤眼鳟	iyz
陈子昂	iza
出资额	ize
出租车	izi
创作室	izu
出租屋	izw
祭敖包	jab
甲岸村	jac
骄傲的	jad
吉奥夫	jaf
骄傲感	jag
晋安河	jah
教案集	jaj
金奥康	jak
甲胺磷	jal
军爱民	jam
吉安娜	jan
静安区	jaq
静安寺	jas
捷安特	jat
吉安市	jau
紧挨着	jav
靖安王	jaw
吉安县	jax
骄傲月	jay
贾庵子	jaz
经不起	jbq
计财部	jcb
急匆匆	jcc
精彩的	jcd
缴存额	jce
教材费	jcf
夹层锅	jcg
检测后	jch
检测出	jci
就曾经	jcj
计财科	jck
记错了	jcl
纠错码	jcm
荆莿鸟	jcn
酱菜瓶	jcp
寄存器	jcq
寄存人	jcr
据测算	jcs
九层塔	jct
决策树	jcu
决策者	jcv
监测网	jcw
紧凑型	jcx
仅次于	jcy
就存在	jcz
记得啊	jda
仅代表	jdb
莙荙菜	jdc
较大的	jdd
聚堆儿	jde
鉴定费	jdf
见到过	jdg
机顶盒	jdh
机动车	jdi
基督教	jdj
街道口	jdk
决定了	jdl
季度末	jdm
见到你	jdn
记得哦	jdo
解毒片	jdp
经得起	jdq
几代人	jdr
鉴定所	jds
进度条	jdt
绝对是	jdu
几点钟	jdv
鉴定为	jdw
决定性	jdx
就等于	jdy
局党组	jdz
己二胺	jea
继而被	jeb
杰尔村	jec
饥饿的	jed
今儿个	jeg
姜恩惠	jeh
假恶丑	jei
焦恩俊	jej
寄蛾科	jek
经二路	jel
姐儿们	jem
九二年	jen
九耳犬	jeq
己二酸	jes
卷耳兔	jet
金恩圣	jeu
加尔文	jew
巨恶心	jex
洁尔阴	jey
纠纷案	jfa
见附表	jfb
记分册	jfc
寄放到	jfd
加富尔	jfe
减肥法	jff
交付给	jfg
解放后	jfh
就非常	jfi
解放军	jfj
积分卡	jfk
解放了	jfl
几方面	jfm
就服你	jfn
警匪片	jfp
解放前	jfq
金夫人	jfr
积分赛	jfs
简繁体	jft
就发生	jfu
几分钟	jfv
金饭碗	jfw
见分晓	jfx
减肥药	jfy
较复杂	jfz
军购案	jga
极个别	jgb
就干脆	jgc
较高的	jgd
究根儿	jge
加工费	jgf
九宫格	jgg
结构化	jgh
加工厂	jgi
据估计	jgj
警告框	jgk
经过了	jgl
见过面	jgm
交给你	jgn
加工品	jgp
机关枪	jgq
几个人	jgr
见光死	jgs
结构图	jgt
结果是	jgu
紧跟着	jgv
交给我	jgw
及格线	jgx
几个月	jgy
几个字	jgz
金海岸	jha
就好比	jhb
角化层	jhc
较好的	jhd
绝活儿	jhe
就恢复	jhf
脚后跟	jhg
结婚后	jhh
救护车	jhi
交换机	jhj
军火库	jhk
就好了	jhl
激活码	jhm
就很难	jhn
江湖派	jhp
精华区	jhq
监护人	jhr
金黄色	jhs
结合体	jht
几乎是	jhu
结婚证	jhv
聚合物	jhw
就好像	jhx
就会有	jhy
将会在	jhz
姐姐啊	jja
精简版	jjb
经济舱	jjc
积极的	jjd
酒劲儿	jje
激将法	jjf
肩胛骨	jjg
基金会	jjh
交界处	jji
经济界	jjj
借记卡	jjk
拒绝了	jjl
见见面	jjm
近几年	jjn
奇奇偶	jjo
咀嚼片	jjp
经济区	jjq
节假日	jjr
晋级赛	jjs
近几天	jjt
仅仅是	jju
紧接着	jjv
救救我	jjw
积极性	jjx
接近于	jjy
仅仅在	jjz
俱乐部	jlb
建立起	jlq
奇偶比	job
金瓯村	joc
紧耦合	joh
解偶联	jol
建瓯市	jou
奇偶性	jox
精辟啊	jpa
金钱案	jqa
进入了	jrl
就认为	jrw
金粟庵	jsa
计算法	jsf
肌酸酐	jsg
近三年	jsn
计算器	jsq
寄宿制	jsv
即所谓	jsw
近似于	jsy
记住啊	jva
就准备	jvb
角质层	jvc
就知道	jvd
叫真儿	jve
截止阀	jvf
价值观	jvg
江浙沪	jvh
就指出	jvi
假正经	jvj
急诊科	jvk
竞争力	jvl
就这么	jvm
就只能	jvn
接住哦	jvo
剪纸片	jvp
居住区	jvq
见证人	jvr
稽征所	jvs
晶状体	jvt
简直是	jvu
竞争者	jvv
建筑物	jvw
集装箱	jvx
就这样	jvy
集中在	jvz
蒋万安	jwa
巨无霸	jwb
进晚餐	jwc
经纬度	jwd
京味儿	jwe
就无法	jwf
就我国	jwg
居委会	jwh
教务处	jwi
鸡尾酒	jwj
教务科	jwk
就完了	jwl
叫我们	jwm
九五年	jwn
假文凭	jwp
就完全	jwq
局外人	jwr
肌萎缩	jws
金维他	jwt
家务事	jwu
健忘症	jwv
吉娃娃	jww
经纬线	jwx
几万元	jwy
教务组	jwz
畸形儿	jxe
经营权	jyq
净资本	jzb
将再次	jzc
将再度	jzd
叫座儿	jze
捐赠法	jzf
就足够	jzg
就做好	jzh
净资产	jzi
将增加	jzj
集资款	jzk
就醉了	jzl
江泽民	jzm
就在那	jzn
橘子皮	jzp
加载器	jzq
就自然	jzr
酱紫色	jzs
金字塔	jzt
建造师	jzu
就在这	jzv
就在我	jzw
加载项	jzx
就在于	jzy
就坐在	jzz
可爱哎	kaa
可爱吧	kab
刻凹槽	kac
可爱多	kad
可爱花	kah
可爱捏	kan
凯奥斯	kas
开安镇	kav
抗癌性	kax
抗癌药	kay
抗艾滋	kaz
快播案	kba
可辨别	kbb
可保存	kbc
看不到	kbd
坎贝尔	kbe
课本费	kbf
看不惯	kbg
科博会	kbh
看不出	kbi
看不见	kbj
看不看	kbk
开办了	kbl
可避免	kbm
可不能	kbn
恐怖片	kbp
看不清	kbq
可辨认	kbr
魁拔四	kbs
看不透	kbt
可不是	kbu
靠不住	kbv
快步舞	kbw
可比性	kbx
可不要	kby
哭鼻子	kbz
快餐部	kcb
康采恩	kce
开采权	kcq
枯草热	kcr
快餐厅	kct
可擦写	kcx
坑点儿	kde
看到了	kdl
看到你	kdn
刻度盘	kdp
靠得住	kdv
口袋罪	kdz
开放啊	kfa
咖啡壶	kfh
开发出	kfi
开发了	kfl
靠父母	kfm
卡凡妮	kfn
开发区	kfq
开放日	kfr
咖啡色	kfs
咖啡厅	kft
开放性	kfx
孔夫子	kfz
肯干啊	kga
客观的	kgd
开关柜	kgg
可更换	kgh
看过了	kgl
抗过敏	kgm
抗干扰	kgr
开公司	kgs
恐高症	kgv
客观性	kgx
嗑瓜子	kgz
看好了	khl
科幻片	khp
开化寺	khs
哭喊着	khv
开车啊	kia
开场白	kib
可储存	kic
宽敞的	kid
烤串儿	kie
可重复	kif
昆虫馆	kig
扛长活	kih
客车厂	kii
空城计	kij
肯吃苦	kik
看出来	kil
开车门	kim
咳喘宁	kin
矿产品	kip
开车去	kiq
可传染	kir
考察团	kit
看成是	kiu
开创者	kiv
开场舞	kiw
可持续	kix
勘察院	kiy
考察组	kiz
课教案	kja
可劲儿	kje
看见你	kjn
抗菌素	kjs
科技园	kjy
看看啊	kka
考科二	kke
卡卡鸡	kkj
看看你	kkn
叩叩趴	kkp
科科斯	kks
空壳子	kkz
快乐啊	kla
克鲁尼	kln
看来我	klw
开门啊	kma
看明白	kmb
开幕词	kmc
孔明灯	kmd
靠门儿	kme
开模费	kmf
看门狗	kmg
开门红	kmh
昆明池	kmi
抗磨剂	kmj
库模块	kmk
喀麦隆	kml
寇萌萌	kmm
看美女	kmn
开门炮	kmp
卡曼奇	kmq
凯美瑞	kmr
康明斯	kms
宽面条	kmt
开幕式	kmu
康美镇	kmv
科目五	kmw
抗磨性	kmx
可没有	kmy
可满足	kmz
坎宁安	kna
可能吧	knb
坑南村	knc
可能的	knd
卡尼尔	kne
开暖风	knf
坤宁宫	kng
可能会	knh
空鸟巢	kni
可能就	knj
柯尼卡	knk
看腻了	knl
可能吗	knm
烤牛奶	knn
烤牛排	knp
开暖气	knq
烤牛肉	knr
喀纳斯	kns
卡诺图	knt
可能是	knu
困难者	knv
可能为	knw
可能性	knx
可能有	kny
可能在	knz
科普部	kpb
开普敦	kpd
开瓢儿	kpe
开瓶费	kpf
开瓶盖	kpg
恐怕会	kph
开辟出	kpi
开盘价	kpj
卡普空	kpk
开辟了	kpl
宽屏幕	kpm
恐怕你	kpn
可偏偏	kpp
开瓶器	kpq
考评人	kpr
开票所	kps
跨平台	kpt
恐怕是	kpu
渴盼着	kpv
宽频网	kpw
康平县	kpx
恐怕要	kpy
考评组	kpz
口腔癌	kqa
狂犬病	kqb
孔雀草	kqc
可取的	kqd
开气儿	kqe
可区分	kqf
空缺感	kqg
坑钱货	kqh
看清楚	kqi
考勤机	kqj
看情况	kqk
看起来	kql
哭泣猫	kqm
空气囊	kqn
孔雀牌	kqp
柯桥区	kqq
看球赛	kqs
空气跳	kqt
矿泉水	kqu
空气中	kqv
孔雀王	kqw
可取消	kqx
烤全羊	kqy
克钦族	kqz
坑人啊	kra
开刃儿	kre
烤肉串	kri
快让开	krk
客容量	krl
看热闹	krn
克瑞强	krq
看热搜	krs
困扰着	krv
可燃物	krw
可溶性	krx
苦日子	krz
亏损额	kse
快速化	ksh
库萨克	ksk
克苏鲁	ksl
坑死你	ksn
开团啊	kta
空调病	ktb
坑头村	ktc
可替代	ktd
卡塔尔	kte
考托福	ktf
可通过	ktg
客套话	kth
口头禅	kti
可调节	ktj
康泰克	ktk
开通了	ktl
看他们	ktm
科托努	ktn
卡通片	ktp
空调器	ktq
烤兔肉	ktr
可调速	kts
卡通图	ktt
口头上	ktu
开拓者	ktv
可眺望	ktw
开拓性	ktx
口头语	kty
课题组	ktz
快说啊	kua
可是我	kuw
控制器	kvq
可追溯	kvs
可恶啊	kwa
枯萎病	kwb
开胃菜	kwc
渴望的	kwd
康沃尔	kwe
考务费	kwf
开外挂	kwg
看完后	kwh
可维持	kwi
库文件	kwj
开网课	kwk
看完了	kwl
靠我们	kwm
矿物泥	kwn
看外婆	kwp
可我却	kwq
科沃斯	kws
看问题	kwt
矿物质	kwv
看外网	kww
开玩笑	kwx
矿物油	kwy
可望在	kwz
科学部	kxb
卡西尔	kxe
开小差	kxi
可惜了	kxl
凯旋炮	kxp
看下去	kxq
看新闻	kxw
可以啊	kya
可以让	kyr
抗组胺	kza
可组合	kzh
孔子庙	kzm
馈赠品	kzp
快做完	kzw
靠左走	kzz
立案率	lal
梁爱琪	laq
联苯胺	lba
老板娘	lbn
流操作	lcz
锂电池	ldi
领导下	ldx
蓝耳病	leb
鲁尔河	leh
绿恶魔	lem
罗尔斯	les
老儿童	let
老儿子	lez
蓝佛安	lfa
冷风暴	lfb
联丰村	lfc
理发店	lfd
棱缝儿	lfe
类方法	lff
卢浮宫	lfg
立法会	lfh
列方程	lfi
拉法基	lfj
乱罚款	lfk
浪费了	lfl
立方米	lfm
礼服呢	lfn
利福平	lfp
立法权	lfq
老夫人	lfr
隆福寺	lfs
立方体	lft
廊坊市	lfu
两分钟	lfv
李风伟	lfw
零风险	lfx
罗非鱼	lfy
老房子	lfz
老公啊	lga
老干部	lgb
拉呱儿	lge
类固醇	lgi
老规矩	lgj
理工类	lgl
留给你	lgn
滤光片	lgp
龙岗区	lgq
两公司	lgs
留给我	lgw
两个月	lgy
厉害啊	lha
拉花儿	lhe
老好人	lhr
灵活性	lhx
撩汉子	lhz
垃圾啊	lja
李克昂	lka
流浪儿	lle
老龄化	llh
浏览器	llq
浏览者	llv
蕾缪安	lma
老婆啊	lpa
老婆饼	lpb
零配件	lpj
冷清清	lqq
拉瑞安	lra
利润额	lre
罗荣桓	lrh
老人们	lrm
罗瑞卿	lrq
硫酸铵	lsa
辣丝丝	lss
聊天啊	lta
论坛报	ltb
乐透彩	ltc
鹿特丹	ltd
老头儿	lte
立体感	ltg
两条路	ltl
令他们	ltm
聊天呢	ltn
老太婆	ltp
愣头青	ltq
蓝田人	ltr
擂台赛	lts
聊天室	ltu
立陶宛	ltw
老同学	ltx
老天爷	lty
老头子	ltz
刘少昂	lua
零障碍	lva
冷招儿	lve
来这里	lvl
来玩啊	lwa
李文秀	lwx
老乡啊	lxa
流行病	lxb
练习册	lxc
联想到	lxd
露馅儿	lxe
陆小凤	lxf
老戏骨	lxg
理想化	lxh
旅行车	lxi
连续剧	lxj
联系卡	lxk
留下来	lxl
老乡们	lxm
李先念	lxn
郎咸平	lxp
两星期	lxq
流行色	lxs
旅行团	lxt
留学生	lxu
老想着	lxv
刘心武	lxw
连续性	lxx
流星雨	lxy
两下子	lxz
李英爱	lya
另一个	lyg
录音棚	lyp
路由器	lyq
另一位	lyw
陆子昂	lza
马鞍形	max
没白熬	mba
明白了	mbl
买不起	mbq
冇错啊	mca
没凑够	mcg
每次在	mcz
木地板	mdb
目的地	mdd
门洞儿	mde
忙得很	mdh
毛滴虫	mdi
买得起	mdq
墨尔本	meb
摩恩城	mei
马尔贾	mej
马尔默	mem
猫儿腻	men
门儿清	meq
摩尔人	mer
迈尔斯	mes
马耳他	met
猫儿食	meu
米尔扎	mev
墨尔文	mew
木耳乡	mex
美尔雅	mey
没儿子	mez
麻烦啊	mfa
没法儿	mfe
面粉厂	mfi
免费看	mfk
麻烦你	mfn
密封圈	mfq
每分钟	mfv
没反应	mfy
买房子	mfz
毛混纺	mhf
马后炮	mhp
冒充我	miw
摩羯座	mjz
命苦啊	mka
迈克尔	mke
没看过	mkg
模块化	mkh
门开了	mkl
马口铁	mkt
没看完	mkw
没口子	mkz
马里奥	mla
马路边	mlb
脉络丛	mlc
没料到	mld
每轮儿	mle
梅兰芳	mlf
摩洛哥	mlg
命令行	mlh
名利场	mli
美利坚	mlj
玫琳凯	mlk
迷了路	mll
没礼貌	mlm
每两年	mln
马力欧	mlo
麻栗坡	mlp
买路钱	mlq
陌路人	mlr
马拉松	mls
麻辣烫	mlt
马铃薯	mlu
面临着	mlv
马拉维	mlw
没良心	mlx
没理由	mly
麻雷子	mlz
妈妈好	mmh
喵喵拳	mmq
每秒钟	mmv
美女啊	mna
没男票	mnp
模拟器	mnq
没挪窝	mnw
没跑儿	mpe
没脾气	mpq
孟婆汤	mpt
没钱啊	mqa
没区别	mqb
马桥村	mqc
明确的	mqd
买期房	mqf
没去过	mqg
母亲河	mqh
摸清楚	mqi
母亲节	mqj
每千克	mqk
没钱了	mql
没钱买	mqm
曼奇尼	mqn
没钱赔	mqp
木器漆	mqq
每千人	mqr
没前途	mqt
米泉市	mqu
免签证	mqv
每千瓦	mqw
明确性	mqx
煤气灶	mqz
没人啊	mra
美人豹	mrb
没人才	mrc
迷人的	mrd
美人儿	mre
毛人风	mrf
没人管	mrg
美如画	mrh
慕容垂	mri
猛然间	mrj
没人看	mrk
没人理	mrl
美人梅	mrm
没人拿	mrn
美容品	mrp
美容器	mrq
毛茸茸	mrr
泌乳素	mrs
名人堂	mrt
美容师	mru
没忍住	mrv
没人味	mrw
没人性	mrx
美容院	mry
没人在	mrz
钼酸铵	msa
慢三步	msb
民俗村	msc
蜜三刀	msd
曼苏尔	mse
民诉法	msf
没送过	msg
马思慧	msh
摸索出	msi
马三家	msj
莫斯科	msk
穆斯林	msl
没锁门	msm
每三年	msn
没碎片	msp
马赛曲	msq
迷死人	msr
麻酥酥	mss
民三庭	mst
貌似是	msu
摸索着	msv
没所谓	msw
民俗学	msx
弥赛亚	msy
美穗子	msz
明天啊	mta
马蹄表	mtb
没听错	mtc
没听懂	mtd
模特儿	mte
没天赋	mtf
没听过	mtg
满堂红	mth
摩托车	mti
没听见	mtj
媒体库	mtk
摩天轮	mtl
面贴膜	mtm
马提尼	mtn
木托盘	mtp
没听清	mtq
木头人	mtr
马桶塞	mts
慢吞吞	mtt
没听说	mtu
茅台镇	mtv
孟庭苇	mtw
满天星	mtx
猫头鹰	mty
明太祖	mtz
谋杀案	mua
密执安	mva
门诊部	mvb
免注册	mvc
没找到	mvd
没准儿	mve
门诊费	mvf
满洲国	mvg
民主化	mvh
明珠城	mvi
民政局	mvj
魔咒课	mvk
命中率	mvl
没这么	mvm
瞒着你	mvn
木制品	mvp
瞄准器	mvq
每周日	mvr
每周三	mvs
莫扎特	mvt
梅州市	mvu
没找着	mvv
没指望	mvw
毛主席	mvx
没注意	mvy
煤砟子	mvz
木卫二	mwe
冥王星	mwx
马西埃	mxa
明细表	mxb
母线槽	mxc
没想到	mxd
马歇尔	mxe
买校服	mxf
墨西哥	mxg
没想好	mxh
模型车	mxi
冒险家	mxj
毛细孔	mxk
描写了	mxl
明星们	mxm
每学年	mxn
明信片	mxp
没兴趣	mxq
某些人	mxr
没心思	mxs
每小题	mxt
每小时	mxu
没想着	mxv
没希望	mxw
没信心	mxx
莫须有	mxy
慢性子	mxz
没有啊	mya
每一步	myb
每一次	myc
没有底	myd
贸易额	mye
每一份	myf
每一个	myg
每一行	myh
母夜叉	myi
每一件	myj
每一刻	myk
没有了	myl
每一秒	mym
每一年	myn
没有哦	myo
慢一拍	myp
没有去	myq
没有人	myr
没意思	mys
每一天	myt
没有谁	myu
每一种	myv
每一位	myw
每一项	myx
没意义	myy
没有做	myz
名字啊	mza
毛泽东	mzd
慢阻肺	mzf
民族化	mzh
满足你	mzn
麻醉品	mzp
麻醉枪	mzq
髦字头	mzt
民族舞	mzw
女保安	nba
你不必	nbb
你别猜	nbc
拿不定	nbd
尼泊尔	nbe
拗不过	nbg
弄不好	nbh
难不成	nbi
那不就	nbj
内部类	nbl
能避免	nbm
能不能	nbn
你别怕	nbp
弄不清	nbq
南霸天	nbt
你不是	nbu
耐不住	nbv
内部网	nbw
牛鼻子	nbz
念慈安	nca
你猜猜	ncc
南翠屏	ncp
女厕所	ncs
内测组	ncz
你的爱	nda
尿道口	ndk
你对他	ndt
难道说	ndu
能等我	ndw
你的心	ndx
哪儿啊	nea
女儿家	nej
娘儿们	nem
女儿墙	neq
尼尔森	nes
你额头	net
你儿子	nez
南方澳	nfa
能分别	nfb
鸟粪层	nfc
你发的	nfd
倪非凡	nff
男法官	nfg
农夫茶	nfi
女方家	nfj
纽芬兰	nfl
男反派	nfp
南芬区	nfq
女粉丝	nfs
内啡肽	nft
耐腐蚀	nfu
年发展	nfv
南方网	nfw
你放心	nfx
女飞贼	nfz
你滚啊	nga
能够把	ngb
你刚才	ngc
念稿儿	nge
宁国府	ngf
你哥哥	ngg
哪个好	ngh
哪个厂	ngi
拿过来	ngl
脑功能	ngn
哪个哦	ngo
哪个盘	ngp
南岗区	ngq
那个人	ngr
扭过头	ngt
女歌手	ngu
你跟着	ngv
你跟我	ngw
农广校	ngx
那个月	ngy
你好啊	nha
那好吧	nhb
闹哄哄	nhh
内环境	nhj
脑海里	nhl
拿回去	nhq
你和他	nht
你和我	nhw
你家啊	nja
拈阄儿	nje
那几个	njg
凝聚力	njl
拿奖牌	njp
年纪轻	njq
你叫我	njw
耐久性	njx
内裤啊	nka
你看过	nkg
你看了	nkl
诺坎普	nkp
尼克斯	nks
牛客网	nkw
内科学	nkx
尿裤子	nkz
努力啊	nla
努力吧	nlb
那里的	nld
娘俩儿	nle
泥疗法	nlf
你老公	nlg
尼罗河	nlh
能力差	nli
能理解	nlj
年历卡	nlk
你老婆	nlp
能力强	nlq
年利润	nlr
浓硫酸	nls
那两条	nlt
女老师	nlu
奴隶制	nlv
尼龙网	nlw
年龄小	nlx
努力做	nlz
那么就	nmj
农牧区	nmq
闹呢啊	nna
牛奶杯	nnb
你哪个	nng
奶牛场	nni
男内裤	nnk
你那里	nnl
男女排	nnp
娘娘腔	nnq
你拿着	nnv
南泥湾	nnw
宁南县	nnx
努努嘴	nnz
娘炮啊	npa
闹脾气	npq
你陪我	npw
你去啊	nqa
您请看	nqk
哪去了	nql
暖气团	nqt
内墙砖	nqv
你签字	nqz
女人啊	nra
男人帮	nrb
能如此	nrc
纳入法	nrf
牛肉干	nrg
宁若初	nri
内燃机	nrj
你让开	nrk
女人们	nrm
女人气	nrq
闹嚷嚷	nrr
能仁寺	nrs
牛肉汤	nrt
聂荣臻	nrv
你认为	nrw
耐热性	nrx
男人鱼	nry
能死啊	nsa
那三个	nsg
倪嗣冲	nsi
弄死你	nsn
内斯塔	nst
浓缩汁	nsv
你退啊	nta
内涂层	ntc
能听懂	ntd
那头儿	nte
蔫土匪	ntf
能通过	ntg
泥头车	nti
那条街	ntj
黏土矿	ntk
那条路	ntl
钕铁硼	ntp
那天起	ntq
牛头人	ntr
内廷司	nts
逆淘汰	ntt
女同志	ntv
女特务	ntw
女同学	ntx
能体验	nty
年投资	ntz
你傻啊	nua
能生存	nuc
你说的	nud
纳税额	nue
那是个	nug
那时候	nuh
年生产	nui
脑神经	nuj
泥石流	nul
拿什么	num
那是哦	nuo
暖水瓶	nup
南山区	nuq
女上司	nus
逆渗透	nut
你是我	nuw
耐受性	nux
你猪啊	nva
内政部	nvb
耐贮藏	nvc
农转非	nvf
你这个	nvg
你真好	nvh
女主持	nvi
你这款	nvk
内置了	nvl
那只能	nvn
女知青	nvq
女主人	nvr
拿着伞	nvs
男侦探	nvt
那只是	nvu
闹着玩	nvw
您只需	nvx
你这样	nvy
那阵子	nvz
内外部	nwb
逆温层	nwc
奈我何	nwh
纳瓦罗	nwl
聂卫平	nwp
脑萎缩	nws
你问我	nww
内外资	nwz
内酰胺	nxa
脑细胞	nxb
那些词	nxc
内心的	nxd
念想儿	nxe
逆向法	nxf
那些个	nxg
你喜欢	nxh
能宣传	nxi
南小街	nxj
囊形科	nxk
你心里	nxl
你信吗	nxm
那些年	nxn
牛小排	nxp
南校区	nxq
那些人	nxr
浓硝酸	nxs
那些天	nxt
女学生	nxu
年薪制	nxv
女性为	nxw
你想想	nxx
你需要	nxy
你现在	nxz
哪有啊	nya
农业部	nyb
那一次	nyc
那样的	nyd
挠痒儿	nye
年夜饭	nyf
哪一个	nyg
女一号	nyh
农用车	nyi
你已经	nyj
那一刻	nyk
哪一类	nyl
那一幕	nym
哪一年	nyn
耐用品	nyp
闹意气	nyq
年月日	nyr
奶油色	nys
那一天	nyt
农业税	nyu
哪一种	nyv
哪一位	nyw
那也行	nyx
暖洋洋	nyy
那样子	nyz
你在啊	nza
酿造厂	nzi
牛字旁	nzp
那自然	nzr
女足赛	nzs
年增长	nzv
农作物	nzw
女子组	nzz
欧安会	oah
区霭玲	oal
欧倍德	obd
偶不会	obh
欧博城	obi
欧伯利	obl
欧巴马	obm
欧倍青	obq
欧巴桑	obs
欧比特	obt
哦不是	obu
欧比旺	obw
欧萃碧	ocb
哦对了	odl
欧迪玛	odm
区大相	odx
欧得洋	ody
殴打罪	odz
偶尔回	oeh
偶尔咳	oek
藕粉饺	ofj
偶发性	ofx
欧歌鸫	ogd
欧共体	ogt
欧会杯	ohb
耦合度	ohd
耦合器	ohq
藕荷色	ohs
偶函数	ohu
欧皇斩	ohv
耦合性	ohx
哦还有	ohy
耦合子	ohz
欧超杯	oib
欧查果	oig
区楚良	oil
欧车前	oiq
呕出物	oiw
欧家坝	ojb
偶觉得	ojd
欧嘉弗	ojf
欧景乐	ojl
欧锦赛	ojs
藕节炭	ojt
偶就是	oju
偶剧系	ojx
欧剑宇	ojy
偶极子	ojz
欧空局	okj
欧克莱	okl
欧克曼	okm
欧克瑟	oks
偶可以	oky
欧罗巴	olb
欧利伐	olf
欧椋鸽	olg
偶联剂	olj
欧雷克	olk
区乐民	olm
欧椋鸟	oln
欧林斯	ols
鸥龙属	olu
欧拉乡	olx
欧莱雅	oly
欧姆贝	omb
欧麦尔	ome
欧敏肤	omf
欧麦格	omg
欧明辉	omh
欧米茄	omj
欧玫珂	omk
欧姆龙	oml
欧美男	omn
哦没事	omu
欧美系	omx
偶没有	omy
欧尼尔	one
欧尼熊	onx
哦哦哦	ooo
欧喷爱	opa
欧佩克	opk
欧珀莱	opl
藕片汤	opt
瓯浦垟	opy
欧倩怡	oqy
偶然的	ord
偶然间	orj
欧若拉	orl
区瑞强	orq
偶然说	oru
偶然性	orx
欧塞尔	ose
藕丝糕	osg
耦丝葵	osk
欧特克	otk
偶蹄类	otl
偶蹄目	otm
呕吐时	otu
呕吐者	otv
呕吐物	otw
藕团乡	otx
区适子	ouz
欧洲杯	ovb
欧洲队	ovd
欧洲化	ovh
欧中建	ovj
偶这里	ovl
欧洲鳗	ovm
欧洲区	ovq
欧洲人	ovr
欧洲司	ovs
欧洲式	ovu
欧洲行	ovx
欧洲游	ovy
欧委会	owh
欧文虫	owi
欧文斯	ows
欧协杯	oxb
欧溪村	oxc
偶稀饭	oxf
偶像化	oxh
欧系车	oxi
偶像剧	oxj
欧协联	oxl
鸥形目	oxm
区晓鸥	oxo
偶像派	oxp
偶像学	oxx
偶现在	oxz
欧营村	oyc
欧亚达	oyd
欧阳锋	oyf
欧元国	oyg
欧阳红	oyh
欧阳超	oyi
欧阳炯	oyj
欧阳克	oyk
偶也来	oyl
欧也妮	oyn
欧元区	oyq
欧阳通	oyt
欧阳生	oyu
欧阳贞	oyv
欧阳文	oyw
欧阳修	oyx
欧阳勇	oyy
藕圆子	oyz
欧足联	ozl
欧紫霞	ozx
平安谷	pag
平安桥	paq
脯氨酸	pas
普安屯	pat
平安夜	pay
派比安	pba
屏蔽布	pbb
皮包骨	pbg
跑步机	pbj
跑不了	pbl
屏蔽墙	pbq
炮兵团	pbt
配备有	pby
陪伴在	pbz
碰瓷儿	pce
评测人	pcr
破大案	pda
派代表	pdb
跑调儿	pde
平底锅	pdg
彭德怀	pdh
判断题	pdt
配电网	pdw
配电箱	pdx
潘恩蓓	peb
裴恩才	pec
普二丁	ped
派尔菲	pef
裴二狗	peg
片儿会	peh
普洱茶	pei
片儿警	pej
排恶露	pel
帕尔马	pem
皮尔斯	pes
帕尔特	pet
普洱市	peu
配额制	pev
普洱县	pex
皮肤癌	pfa
跑分儿	pfe
平方根	pfg
平方和	pfh
剖腹产	pfi
批发价	pfj
排放量	pfl
平方米	pfm
佩服你	pfn
平房区	pfq
平凡人	pfr
骗粉丝	pfs
皮筏艇	pft
皮肤针	pfv
漂浮物	pfw
皮肤癣	pfx
票贩子	pfz
膀胱癌	pga
彭怀安	pha
平湖村	phc
平衡阀	phf
平滑肌	phj
拍黄片	php
品红色	phs
破解过	pjg
平均年	pjn
评价人	pjr
帕金森	pjs
贫困县	pkx
漂亮啊	pla
漂亮吧	plb
平流层	plc
毗邻的	pld
破烂儿	ple
排列法	plf
疲劳感	plg
漂亮话	plh
排列成	pli
评论家	plj
普朗克	plk
披露了	pll
拼了命	plm
骗了你	pln
拍了拍	plp
评论区	plq
排卵日	plr
普莱斯	pls
爬楼梯	plt
泼冷水	plu
评论者	plv
霹雳舞	plw
凭良心	plx
评论员	ply
普立兹	plz
破棉袄	pma
拼命的	pmd
怕麻烦	pmf
破灭了	pml
怕你啊	pna
陪你玩	pnw
陪你走	pnz
跑跑啊	ppa
耙耙柑	ppg
碰碰车	ppi
拼拼看	ppk
评评理	ppl
婆婆们	ppm
帕帕尼	ppn
飘飘然	ppr
爬爬赛	pps
泡泡糖	ppt
批评者	ppv
拍拍网	ppw
泡泡浴	ppy
撇撇嘴	ppz
脾气暴	pqb
劈情操	pqc
排球队	pqd
跑圈儿	pqe
排气阀	pqf
排气管	pqg
脾气好	pqh
排球场	pqi
派遣军	pqj
排气口	pqk
爬起来	pql
普契尼	pqn
曝气盘	pqp
聘请去	pqq
排球赛	pqs
铍青铜	pqt
排气扇	pqu
剽窃者	pqv
排球网	pqw
迫切性	pqx
盆腔炎	pqy
碰巧在	pqz
骗人布	prb
骗人的	prd
普瑞尔	pre
烹饪法	prf
裴如海	prh
漂染厂	pri
平日价	prj
平日里	prl
拼人气	prq
蒲绒绒	prr
派瑞松	prs
膨润土	prt
譬如说	pru
聘任制	prv
破任务	prw
烹饪学	prx
皮褥子	prz
盘丝饼	psb
朴素的	psd
瓶塞儿	pse
配送费	psf
怕死鬼	psg
盘损坏	psh
怕塞车	psi
破碎机	psj
帕斯卡	psk
蒲松龄	psl
菩萨蛮	psm
拍死你	psn
配色盘	psp
裴涩琪	psq
排酸肉	psr
扑簌簌	pss
帕萨特	pst
盘飧市	psu
盘算着	psv
判死刑	psx
配速员	psy
喷洒在	psz
葡糖胺	pta
排头兵	ptb
葡萄村	ptc
跑堂的	ptd
跑堂儿	pte
烹调法	ptf
葡萄干	ptg
普通话	pth
普通车	pti
葡萄酒	ptj
拼图块	ptk
泡汤了	ptl
怕他们	ptm
帕台农	ptn
泡腾片	ptp
普陀区	ptq
普通人	ptr
帕特森	pts
葡萄糖	ptt
平台上	ptu
葡萄汁	ptv
骈体文	ptw
排他性	ptx
葡萄牙	pty
葡萄籽	ptz
抛尸案	pua
平山县	pux
凭着爱	pva
平装本	pvb
盘中餐	pvc
品种的	pvd
朴正恩	pve
辟支佛	pvf
偏振光	pvg
破折号	pvh
评职称	pvi
凭直觉	pvj
偏执狂	pvk
批准了	pvl
朴哲民	pvm
陪着你	pvn
拍照片	pvp
批准权	pvq
批准人	pvr
普照寺	pvs
配置图	pvt
批准书	pvu
碰撞中	pvv
陪着我	pvw
皮脂腺	pvx
偏重于	pvy
拍桌子	pvz
骗我啊	pwa
评委会	pwh
培训班	pxb
埔心村	pxc
平行度	pxd
潘锡恩	pxe
培训费	pxf
平型关	pxg
培训会	pxh
评选出	pxi
配线架	pxj
螃蟹壳	pxk
谱写了	pxl
跑解马	pxm
帕西诺	pxn
拍胸脯	pxp
劈下去	pxq
派息日	pxr
评选赛	pxs
潘晓婷	pxt
培训师	pxu
培训者	pxv
评选为	pxw
平行线	pxx
偏向于	pxy
胖小子	pxz
朋友啊	pya
朋友吧	pyb
聘英才	pyc
颇有点	pyd
普约尔	pye
培养费	pyf
派一个	pyg
鄱阳湖	pyh
培养出	pyi
培养基	pyj
排烟口	pyk
偏移量	pyl
朋友们	pym
皮亚诺	pyn
彭养鸥	pyo
评一评	pyp
朋友圈	pyq
培养人	pyr
培养所	pys
跑一趟	pyt
濮阳市	pyu
聘用制	pyv
朋友问	pyw
皮影戏	pyx
彭于晏	pyy
评议组	pyz
匹兹堡	pzb
骗子多	pzd
盆栽哥	pzg
片仔癀	pzh
排子车	pzi
怕自己	pzj
排在前	pzq
彭遵泗	pzs
排座位	pzw
彭泽县	pzx
帕祖祖	pzz
气昂昂	qaa
去爱吧	qab
前垵村	qac
亲爱的	qad
抢暗杠	qag
鞘氨醇	qai
祁安路	qal
曲阿奴	qan
请安排	qap
奇奥萨	qas
清艾条	qat
迁安市	qau
请安装	qav
秦安县	qax
齐爱云	qay
前北岸	qba
气不平	qbp
卡脖子	qbz
却从不	qcb
前村村	qcc
清脆的	qcd
七次方	qcf
去参观	qcg
七彩虹	qch
器材厂	qci
请参见	qcj
请参考	qck
却从来	qcl
抢菜买	qcm
全彩屏	qcp
起草人	qcr
千层酥	qcs
青菜头	qct
其次是	qcu
潜藏着	qcv
却从未	qcw
强磁性	qcx
请参阅	qcy
潜藏在	qcz
期待爱	qda
球蛋白	qdb
抢到菜	qdc
恰当的	qdd
七对儿	qde
清道夫	qdf
齐墩果	qdg
启动后	qdh
骑单车	qdi
请点击	qdj
骑得快	qdk
取得了	qdl
骑的马	qdm
黔东南	qdn
启动盘	qdp
瞧得起	qdq
签订日	qdr
强调色	qds
其独特	qdt
缺点是	qdu
期待着	qdv
确定为	qdw
确定性	qdx
秋刀鱼	qdy
启动组	qdz
穷二代	qed
权恩妃	qef
邱娥国	qeg
丘尔金	qej
乔尔玛	qem
去二年	qen
企鹅牌	qep
蛐儿蛐	qeq
企鹅肉	qer
企鹅头	qet
雀儿山	qeu
曲峨镇	qev
圈儿外	qew
切尔西	qex
齐二药	qey
亲儿子	qez
千伏安	qfa
全封闭	qfb
秋风辞	qfc
侵犯到	qfd
区分法	qff
清风阁	qfg
且符合	qfh
千分尺	qfi
群发机	qfj
区分开	qfk
侵犯了	qfl
全方面	qfm
秦丰农	qfn
群芳谱	qfp
群发器	qfq
欺负人	qfr
氢氟酸	qfs
欺负他	qft
启发式	qfu
千分之	qfv
全方位	qfw
却发现	qfx
区法院	qfy
起房子	qfz
奇怪啊	qga
乞丐版	qgb
去观测	qgc
穷光蛋	qgd
枪杆儿	qge
前滚翻	qgf
气鼓鼓	qgg
庆功会	qgh
全过程	qgi
切割机	qgj
其公开	qgk
奇怪了	qgl
请购买	qgm
全功能	qgn
齐广璞	qgp
曲棍球	qgq
七个人	qgr
区公所	qgs
请跟帖	qgt
情感上	qgu
请告知	qgv
请各位	qgw
全国性	qgx
七个月	qgy
潜规则	qgz
企划案	qha
强化班	qhb
青花瓷	qhc
秦皇岛	qhd
轻活儿	qhe
请回复	qhf
齐桓公	qhg
气呼呼	qhh
七海雏	qhi
取号机	qhj
迁户口	qhk
亲和力	qhl
群号码	qhm
氰化钠	qhn
求和平	qhp
琼华侨	qhq
侵害人	qhr
浅黄色	qhs
签合同	qht
青海省	qhu
求婚者	qhv
氰化物	qhw
其核心	qhx
全行业	qhy
穷孩子	qhz
抢劫案	qja
奇迹般	qjb
前几次	qjc
旗舰店	qjd
丘吉尔	qje
全家福	qjf
前几个	qjg
秋交会	qjh
去机场	qji
清洁剂	qjj
取景框	qjk
请见谅	qjl
前几名	qjm
前几年	qjn
敲键盘	qjp
取景器	qjq
全家人	qjr
前景色	qjs
前几天	qjt
请及时	qju
全剧终	qjv
区纪委	qjw
全局性	qjx
取决于	qjy
抢劫罪	qjz
起开啊	qka
去了啊	qla
前脸儿	qle
前列腺	qlx
亲妈啊	qma
墙内篇	qnp
求偶期	qoq
求偶者	qov
青苹果	qpg
汽配网	qpw
去人啊	qra
羟色胺	qsa
前三场	qsi
起诉科	qsk
气死了	qsl
情色片	qsp
去铁胺	qta
曲檀儿	qte
青铜色	qts
请通知	qtv
仇兆鳌	qva
掐着表	qvb
清真菜	qvc
群众的	qvd
区政府	qvf
全中国	qvg
前缀和	qvh
球轴承	qvi
起重机	qvj
期中考	qvk
倾注了	qvl
请注明	qvm
却只能	qvn
亲中派	qvp
去追求	qvq
圈中人	qvr
清真寺	qvs
去找他	qvt
泉州市	qvu
求职者	qvv
全中文	qvw
强制性	qvx
请注意	qvy
前阵子	qvz
求我啊	qwa
请务必	qwb
钱王祠	qwc
权威的	qwd
去污粉	qwf
千万个	qwg
全委会	qwh
清王朝	qwi
气雾剂	qwj
蔷薇科	qwk
全完了	qwl
前五名	qwm
请问你	qwn
青蛙趴	qwp
轻武器	qwq
千万人	qwr
蔷薇色	qws
青蛙头	qwt
千瓦时	qwu
期望值	qwv
全文完	qww
权威性	qwx
千万元	qwy
墙围子	qwz
全西安	qxa
情绪化	qxh
汽修厂	qxi
取消了	qxl
期限内	qxn
钱学森	qxs
青玉案	qya
前一段	qyd
起眼儿	qye
七月份	qyf
前一个	qyg
企业化	qyh
企业家	qyj
瞧一瞧	qyq
却依然	qyr
清一色	qys
却总爱	qza
签字笔	qzb
屈子祠	qzc
全自动	qzd
枪子儿	qze
求租房	qzf
勤杂工	qzg
全宗号	qzh
起早床	qzi
前增加	qzj
区字框	qzk
圈子里	qzl
亲姊妹	qzm
却总能	qzn
铅字盘	qzp
前奏曲	qzq
全自然	qzr
浅紫色	qzs
前总统	qzt
却总是	qzu
亲子装	qzv
千字文	qzw
青藏线	qzx
起作用	qzy
去走走	qzz
仁爱礁	raj
仁爱路	ral
若按你	ran
仁安羌	raq
瑞安市	rau
融安县	rax
日报表	rbb
日本菜	rbc
容不得	rbd
柔贝儿	rbe
热备份	rbf
日本国	rbg
日本海	rbh
认不出	rbi
人比较	rbj
人别哭	rbk
饶不了	rbl
日本妹	rbm
仍不能	rbn
日本片	rbp
惹不起	rbq
让别人	rbr
乳白色	rbs
人不同	rbt
若不是	rbu
忍不住	rbv
容不下	rbx
日本语	rby
人不在	rbz
人才啊	rca
仁慈的	rcd
人才观	rcg
人才处	rci
人才局	rcj
若错了	rcl
如从前	rcq
人才网	rcw
容错性	rcx
人代表	rdb
肉嘟嘟	rdd
入洞房	rdf
热导管	rdg
惹的祸	rdh
热电厂	rdi
让大家	rdj
肉豆蔻	rdk
人多了	rdl
桡动脉	rdm
让电脑	rdn
热电偶	rdo
人都怕	rdp
熔断器	rdq
瑞典人	rdr
肉毒素	rds
认得他	rdt
人的手	rdu
忍得住	rdv
瑞典文	rdw
热镀锌	rdx
热带鱼	rdy
热电阻	rdz
若尔盖	reg
任恩敬	rej
软儿梨	rel
日耳曼	rem
壬二酸	res
然而是	reu
热付通	rft
人贩子	rfz
如果爱	rga
日光灯	rgd
若干个	rgg
肉骨茶	rgi
如果仅	rgj
人工林	rgl
如果能	rgn
人格权	rgq
肉骨头	rgt
如果说	rgu
扔给我	rgw
热固性	rgx
然后按	rha
然后把	rhb
如何改	rhg
然后就	rhj
融合了	rhl
入户门	rhm
然后呢	rhn
惹尘埃	ria
日程表	rib
热忱的	rid
入场费	rif
润唇膏	rig
入朝后	rih
日出场	rii
认出来	ril
日驰尼	rin
人吃人	rir
荣成市	riu
荣成湾	riw
若出现	rix
仍处于	riy
让肌肤	rjf
阮经天	rjt
人尖子	rjz
让开吧	rkb
认可的	rkd
热咖啡	rkf
软口盖	rkg
让客户	rkh
入口处	rki
如会计	rkj
绕口令	rkl
惹口面	rkm
仍可能	rkn
人看人	rkr
热扩散	rks
热炕头	rkt
人口数	rku
认可者	rkv
软科学	rkx
仍可以	rky
日喀则	rkz
扔了啊	rla
扰流板	rlb
燃料舱	rlc
热烈的	rld
人来疯	rlf
日了狗	rlg
日落黄	rlh
人力车	rli
软链接	rlj
燃料库	rlk
人流量	rll
热冷面	rlm
日历年	rln
容量瓶	rlp
扰流器	rlq
揉了揉	rlr
染了色	rls
人来说	rlu
人流中	rlv
容量为	rlw
热力学	rlx
燃料油	rly
惹娄子	rlz
人命案	rma
人民币	rmb
人名册	rmc
人民党	rmd
肉末儿	rme
惹麻烦	rmf
让美国	rmg
如梦幻	rmh
热门车	rmi
热卖价	rmj
人麻了	rml
软绵绵	rmm
乳糜尿	rmn
入门篇	rmp
任免权	rmq
软木塞	rms
让媒体	rmt
任命书	rmu
入门者	rmv
人民网	rmw
热敏性	rmx
若没有	rmy
人马座	rmz
让那边	rnb
忍耐的	rnd
让你飞	rnf
让那个	rng
让你喊	rnh
热奶茶	rni
热闹劲	rnj
让你看	rnk
忍耐力	rnl
让你们	rnm
任你拿	rnn
让你跑	rnp
让女人	rnr
热耐思	rns
任你挑	rnt
揉捏着	rnv
日内瓦	rnw
汝南县	rnx
热那亚	rny
让你在	rnz
韧皮部	rpb
如瀑地	rpd
肉片儿	rpe
人品好	rph
乳品厂	rpi
日牌价	rpj
人皮脸	rpl
饶平如	rpr
肉蒲团	rpt
软盘上	rpu
热膨胀	rpv
饶平县	rpx
人气榜	rqb
融洽的	rqd
瑞切尔	rqe
若侵犯	rqf
让全国	rqg
绒球花	rqh
让汽车	rqi
燃气具	rqj
人情款	rqk
热起来	rql
容器内	rqn
热气球	rqq
乳清酸	rqs
让其他	rqt
任丘市	rqu
人群中	rqv
人情味	rqw
若羌县	rqx
让企业	rqy
绕圈子	rqz
人人爱	rra
仍然会	rrh
揉揉看	rrk
若他不	rtb
人太多	rtd
人头费	rtf
认同感	rtg
软通货	rth
乳糖醇	rti
乳头肌	rtj
软条款	rtk
让他来	rtl
让他们	rtm
人体内	rtn
热天气	rtq
人托人	rtr
人胎素	rts
热腾腾	rtt
肉体上	rtu
乳头状	rtv
让台湾	rtw
壤塘县	rtx
乳突炎	rty
认识啊	rua
妊娠纹	ruw
软着陆	rvl
乳制品	rvp
绕指柔	rvr
人渣滓	rvz
人武部	rwb
任务层	rwc
人为的	rwd
入味儿	rwe
仍无法	rwf
让我哥	rwg
让我回	rwh
任务池	rwi
让玩家	rwj
让我看	rwk
任务栏	rwl
让我们	rwm
让我拿	rwn
热瓦普	rwp
让我去	rwq
热污染	rwr
让我死	rws
认为他	rwt
认为是	rwu
任务重	rwv
让我无	rww
任我行	rwx
让位于	rwy
让我再	rwz
乳腺癌	rxa
柔性版	rxb
荣星村	rxc
人行道	rxd
肉馅儿	rxe
软下疳	rxg
人性化	rxh
热心肠	rxi
绕线机	rxj
入学考	rxk
入学率	rxl
人性美	rxm
热性能	rxn
任贤齐	rxq
人下人	rxr
人相似	rxs
如下图	rxt
让学生	rxu
入选者	rxv
日新闻	rxw
让学校	rxx
仍需要	rxy
人行走	rxz
容易把	ryb
日用瓷	ryc
热压釜	ryf
让一个	ryg
让用户	ryh
人与车	ryi
软硬件	ryj
容易了	ryl
肉用牛	ryn
日用品	ryp
绕一圈	ryq
人与人	ryr
瑞岩寺	rys
日月潭	ryt
肉芽肿	ryv
忍一下	ryx
如有意	ryy
肉圆子	ryz
人字旁	rzp
融资券	rzq
人造石	rzu
遂安伯	sab
随便啊	sba
随便吧	sbb
酸白菜	sbc
算不得	sbd
碎步儿	sbe
三部分	sbf
三百个	sbg
所包含	sbh
随便吃	sbi
三八节	sbj
斯波克	sbk
算不了	sbl
三部门	sbm
虽不能	sbn
赛比欧	sbo
三百篇	sbp
三部曲	sbq
三百人	sbr
算不算	sbs
所不同	sbt
算不上	sbu
三不沾	sbv
三百万	sbw
四不像	sbx
三百元	sby
腮帮子	sbz
色彩感	scg
酸催化	sch
三层楼	scl
色彩屏	scp
三寸舌	scu
三都澳	sda
三等舱	sdc
所得额	sde
三等功	sdg
苏丹红	sdh
三等奖	sdj
斯大林	sdl
隧道南	sdn
苏东坡	sdp
散弹枪	sdq
扫地僧	sds
算得上	sdu
赛迪网	sdw
锁定在	sdz
塞尔伦	sel
三恶趣	seq
司法部	sfb
三分地	sfd
送分儿	sfe
随风飞	sff
所覆盖	sfg
绥芬河	sfh
散发出	sfi
司法局	sfj
送风口	sfk
算法类	sfl
私房钱	sfq
孙夫人	sfr
三法司	sfs
三伏天	sft
所发生	sfu
三分钟	sfv
私服网	sfw
四方形	sfx
索菲亚	sfy
随份子	sfz
三国策	sgc
所规定	sgd
三姑夫	sgf
死光光	sgg
桑干河	sgh
三宫椿	sgi
三个键	sgj
三公开	sgk
苏格兰	sgl
塑钢门	sgm
送给你	sgn
算个屁	sgp
送过去	sgq
三公司	sgs
送给他	sgt
三国杀	sgu
三国志	sgv
送给我	sgw
萨嘎县	sgx
三个月	sgy
三个字	sgz
孙河村	shc
松花蛋	shd
三孩儿	she
松花湖	shh
宋慧乔	shq
送货人	shr
损害者	shv
搜狐网	shw
三号线	shx
宋徽宗	shz
四重奏	siz
三句话	sjh
私家车	sji
斯佳丽	sjl
丧家犬	sjq
孙家湾	sjw
四君子	sjz
三孔鼻	skb
三坑村	skc
送快递	skd
四块二	ske
所开发	skf
萨克管	skg
所困惑	skh
三卡池	ski
散客价	skj
松垮垮	skk
撕开了	skl
三康庙	skm
所苦恼	skn
四块魮	skp
松口气	skq
所困扰	skr
萨克斯	sks
思考题	skt
三棵树	sku
思考着	skv
撒克逊	skx
斯利安	sla
算了吧	slb
缩略词	slc
塑料袋	sld
三轮儿	sle
森林法	slf
三连跪	slg
三里河	slh
三轮车	sli
四六级	slj
四六开	slk
森林里	sll
所罗门	slm
苏里南	sln
塑料瓶	slp
孙立群	slq
苏联人	slr
算了算	sls
缩略图	slt
苏黎世	slu
耸立着	slv
送礼物	slw
三两下	slx
司令员	sly
散落在	slz
司米安	sma
三米板	smb
三民村	smc
三摩地	smd
三毛儿	sme
三面翻	smf
司马光	smg
赛马会	smh
赛马场	smi
萨满教	smj
司门口	smk
所面临	sml
色眯眯	smm
司马南	smn
司马丕	smp
思明区	smq
色目人	smr
萨默斯	sms
酸梅汤	smt
三明市	smu
三明治	smv
三毛五	smw
三门峡	smx
扫描仪	smy
宋木子	smz
随你便	snb
苏内村	snc
萨内蒂	snd
孙女儿	sne
桑拿房	snf
所能够	sng
算你狠	snh
送奶茶	sni
四年级	snj
斯诺克	snk
三年来	snl
随你们	snm
三年内	snn
斯内普	snp
三年前	snq
酸牛乳	snr
萨诺斯	sns
桑拿天	snt
遂宁市	snu
三年制	snv
三娘湾	snw
睢宁县	snx
桑拿浴	sny
三娘子	snz
索赔案	spa
桑坡村	spc
桑普多	spd
三盆儿	spe
色谱法	spf
酸苹果	spg
娑婆诃	sph
丝盘虫	spi
伞铺街	spj
斯派克	spk
撕破脸	spl
三匹马	spm
撒泡尿	spn
孙婆婆	spp
索赔权	spq
索赔人	spr
斯潘塞	sps
酸葡萄	spt
四平市	spu
桑皮纸	spv
斯派维	spw
松潘县	spx
色谱仪	spy
三拍子	spz
送秋波	sqb
森七菜	sqc
所取得	sqd
撒切尔	sqe
三七分	sqf
三千个	sqg
索取号	sqh
四驱车	sqi
死全家	sqj
色情狂	sqk
算起来	sql
萨其马	sqm
三千年	sqn
色情片	sqp
死翘翘	sqq
三千人	sqr
四强赛	sqs
三清潭	sqt
宿迁市	squ
粟丘疹	sqv
四千万	sqw
宿迁县	sqx
三缺一	sqy
三七仔	sqz
三热爱	sra
桑葚儿	sre
孙若丰	srf
散热膏	srg
虽然会	srh
速溶茶	sri
三人间	srj
死人了	srl
虽然能	srn
散热片	srp
虽然仍	srr
四人赛	srs
送人头	srt
孙若微	srw
三人行	srx
诉讼案	ssa
宋思衡	ssh
三四排	ssp
搜索器	ssq
嗖嗖嗖	sss
三四天	sst
三四五	ssw
三同步	stb
司徒村	stc
桑坦德	std
松塔儿	ste
斯坦福	stf
所提供	stg
三天后	sth
所推出	sti
三头肌	stj
斯塔克	stk
斯坦利	stl
斯塔姆	stm
桑塔纳	stn
搔头皮	stp
三天前	stq
三体人	str
斯通斯	sts
四条腿	stt
三同时	stu
司徒钟	stv
三套娃	stw
三条线	stx
所特有	sty
宋太祖	stz
算啥啊	sua
三十二	sue
锁住了	svl
苏维埃	swa
四五百	swb
四五次	swc
所谓的	swd
骚味儿	swe
所无法	swf
四五个	swg
三尾惠	swh
色王朝	swi
散文集	swj
孙悟空	swk
死亡率	swl
送外卖	swm
四五年	swn
三五炮	swp
四五千	swq
三万人	swr
四五岁	sws
三五天	swt
四五十	swu
死亡者	swv
四万万	sww
俗文学	swx
四五月	swy
送物资	swz
苏小安	sxa
三厢版	sxb
缩写词	sxc
三兄弟	sxd
素馅儿	sxe
死刑犯	sxf
三邪关	sxg
死循环	sxh
三厢车	sxi
四星级	sxj
随心看	sxk
私下里	sxl
苏小妹	sxm
司小念	sxn
松下牌	sxp
随想曲	sxq
送信人	sxr
三希堂	sxt
三小时	sxu
思想者	sxv
色香味	sxw
思想性	sxx
死心眼	sxy
所选择	sxz
苏永安	sya
宋允儿	sye
所有格	syg
私有化	syh
岁月里	syl
所以能	syn
苏有朋	syp
扫一扫	sys
四月天	syt
所以说	syu
所以我	syw
所拥有	syy
嗓子好	szh
三唑仑	szl
算在内	szn
随葬品	szp
松子酥	szs
宋子文	szw
所在组	szz
特保案	tba
特别版	tbb
挺不错	tbc
听不到	tbd
贴本儿	tbe
特别法	tbf
逃不过	tbg
特别好	tbh
听不出	tbi
听不见	tbj
太不可	tbk
太棒了	tbl
同胞们	tbm
他把你	tbn
托比欧	tbo
天不怕	tbp
听不清	tbq
投标人	tbr
同步锁	tbs
听不听	tbt
特别是	tbu
特别重	tbv
淘宝网	tbw
他不想	tbx
特别要	tby
特别在	tbz
探测器	tcq
听的歌	tdg
他的钱	tdq
天鹅堡	teb
兔耳草	tec
兔耳朵	ted
吐尔根	teg
天鹅湖	teh
太饿了	tel
塔尔坡	tep
土耳其	teq
托儿所	tes
梯恩梯	tet
掏耳勺	teu
台儿庄	tev
他儿子	tez
挺方便	tfb
太讽刺	tfc
颓废的	tfd
他仿佛	tff
托付给	tfg
特服号	tfh
通风处	tfi
挺费劲	tfj
通风口	tfk
投放量	tfl
同分母	tfm
特烦恼	tfn
颓废派	tfp
通风器	tfq
太夫人	tfr
铜佛寺	tfs
太妃糖	tft
头发上	tfu
停放着	tfv
铁饭碗	tfw
突发性	tfx
谭富英	tfy
太复杂	tfz
台港澳	tga
泰戈尔	tge
提供方	tgf
太古城	tgi
同甘苦	tgk
退给你	tgn
谈个屁	tgp
塘沽区	tgq
他告诉	tgs
团购网	tgw
桃花庵	tha
唐长安	tia
挺可爱	tka
谈恋爱	tla
头两步	tlb
天籁村	tlc
贪婪的	tld
趿拉儿	tle
吐鲁番	tlf
讨论稿	tlg
讨论会	tlh
透漏出	tli
拖拉机	tlj
挺凉快	tlk
太累了	tll
塔里木	tlm
陀罗尼	tln
特朗普	tlp
讨论区	tlq
同龄人	tlr
天蓝色	tls
听了听	tlt
他脸上	tlu
凸轮轴	tlv
铜锣湾	tlw
铁了心	tlx
特洛伊	tly
停留在	tlz
挺暖和	tnh
太年轻	tnq
挺拼啊	tpa
藤浦惠	tph
太平鸟	tpn
弹琵琶	tpp
汤普森	tps
谈判中	tpv
太平王	tpw
贪便宜	tpy
退群吧	tqb
烫青菜	tqc
跆拳道	tqd
听曲儿	tqe
提取法	tqf
淘气鬼	tqg
投洽会	tqh
听清楚	tqi
探亲假	tqj
通气孔	tqk
听起来	tql
脱氢酶	tqm
同情你	tqn
提前批	tqp
天桥区	tqq
天气热	tqr
天青色	tqs
抬起头	tqt
同期声	tqu
通勤装	tqv
提取物	tqw
同情心	tqx
提取液	tqy
他亲自	tqz
投入比	trb
糖人儿	tre
特任官	trg
太让人	trr
天然色	trs
投融资	trz
碳酸铵	tsa
唐赛儿	tse
铁丝网	tsw
头疼啊	tta
听听吧	ttb
团体操	ttc
偷偷地	ttd
褪套儿	tte
团头鲂	ttf
退堂鼓	ttg
天天好	tth
土特产	tti
推土机	ttj
挺痛苦	ttk
吞吐量	ttl
替他们	ttm
天堂鸟	ttn
团体票	ttp
贴图区	ttq
他突然	ttr
淘汰赛	tts
通天塔	ttt
提提神	ttu
团团转	ttv
抬头纹	ttw
谈谈心	ttx
天通苑	tty
唐太宗	ttz
跳上岸	tua
挑事儿	tue
图书城	tui
天主教	tvj
停止了	tvl
通州区	tvq
挑战赛	tvs
贪污案	twa
图文版	twb
同温层	twc
太无敌	twd
贪玩儿	twe
体位法	twf
滕王阁	twg
题外话	twh
跳舞场	twi
头文件	twj
图文框	twk
太晚了	twl
同我们	twm
台湾牛	twn
调味品	twp
摊位前	twq
台湾人	twr
同位素	tws
天文台	twt
听我说	twu
提问者	twv
他问我	tww
天文学	twx
贪污罪	twz
同学啊	txa
通信兵	txb
田心村	txc
剃须刀	txd
听信儿	txe
通行费	txf
提刑官	txg
挺喜欢	txh
体现出	txi
谈笑间	txj
太辛苦	txk
停下来	txl
同学们	txm
提醒您	txn
天仙配	txp
跳下去	txq
贴心人	txr
土行孙	txs
弹性体	txt
通讯社	txu
通行证	txv
提醒我	txw
他相信	txx
同心圆	txy
体现在	txz
太阳能	tyn
太阳伞	tys
陶子安	tza
投资部	tzb
投资额	tze
太在乎	tzh
桐梓坡	tzp
投资网	tzw
上班啊	uba
申报表	ubb
十八层	ubc
说不定	ubd
双棒儿	ube
少部分	ubf
数百个	ubg
势必会	ubh
说不出	ubi
省部级	ubj
升本科	ubk
受不了	ubl
数百名	ubm
上半年	ubn
十八盘	ubp
上不去	ubq
数百人	ubr
十八岁	ubs
双胞胎	ubt
是不是	ubu
睡不着	ubv
说不完	ubw
睡不醒	ubx
上半夜	uby
上辈子	ubz
收藏啊	uca
生存期	ucq
啥操作	ucz
是的啊	uda
上等兵	udb
上档次	udc
闪道儿	ude
山地车	udi
收到了	udl
是多么	udm
十多年	udn
说得清	udq
山东人	udr
十多岁	uds
十多天	udt
山东省	udu
史蒂文	udw
是典型	udx
书呆子	udz
涉恶案	uea
十二号	ueh
烧鹅仔	uez
十分爱	ufa
食管癌	uga
施工方	ugf
受贿案	uha
瘦猴儿	uhe
适合你	uhn
生活区	uhq
生活中	uhv
生活在	uhz
睡觉啊	uja
数据线	ujx
水口村	ukc
沙克尔	uke
时空观	ukg
说空话	ukh
收款机	ukj
石坑崆	ukk
是可能	ukn
收款台	ukt
上课时	uku
盛开着	ukv
使两岸	ula
水利部	ulb
树凉儿	ule
受理费	ulf
输卵管	ulg
史莱克	ulk
设立了	ull
实力派	ulp
树立起	ulq
十六位	ulw
什么啊	uma
什么病	umb
什么菜	umc
什么的	umd
升米恩	ume
什么法	umf
什么鬼	umg
什么话	umh
寿命长	umi
双面胶	umj
枢木葵	umk
生命力	uml
什么吗	umm
什么呢	umn
什么哦	umo
什么牌	ump
是目前	umq
什么人	umr
史密斯	ums
生命体	umt
什么是	umu
生命值	umv
商贸网	umw
生命线	umx
什么样	umy
什么最	umz
施耐庵	una
水泥板	unb
省内存	unc
上年度	und
水牛儿	une
少年犯	unf
少年宫	ung
数年后	unh
水泥厂	uni
伤脑筋	unj
受虐狂	unk
十年来	unl
是你吗	unm
少奶奶	unn
是你哦	uno
施虐癖	unp
十年前	unq
受难日	unr
室内赛	uns
仕女图	unt
十年少	unu
受难者	unv
室内外	unw
神农溪	unx
石脑油	uny
室女座	unz
视频啊	upa
审批表	upb
适配层	upc
输配电	upd
十盆儿	upe
商品房	upf
审判官	upg
商品化	uph
售票处	upi
收盘价	upj
射频卡	upk
上坡路	upl
水平面	upm
双皮奶	upn
沈培培	upp
适配器	upq
审批人	upr
世乒赛	ups
说破天	upt
山坡上	upu
审判长	upv
食品网	upw
水平线	upx
售票员	upy
生僻字	upz
双氰胺	uqa
申请表	uqb
水芹菜	uqc
失去的	uqd
砂浅儿	uqe
十七分	uqf
暑期工	uqg
申请号	uqh
说清楚	uqi
双球菌	uqj
啥情况	uqk
失去了	uql
数千名	uqm
数千年	uqn
石桥铺	uqp
上前去	uqq
申请人	uqr
十七岁	uqs
设圈套	uqt
申请书	uqu
申请者	uqv
上千万	uqw
授权下	uqx
数千亿	uqy
烧茄子	uqz
杀人案	ura
受日本	urb
输入国	urg
双刃剑	urj
输入框	urk
是人类	url
数日内	urn
双人旁	urp
十日前	urq
受让人	urr
十日谈	urt
上饶市	uru
双人舞	urw
水溶性	urx
水溶液	ury
上诉案	usa
诗三百	usb
十三层	usc
世俗的	usd
食宿费	usf
十三个	usg
世俗化	ush
输送车	usi
输送机	usj
十三课	usk
杀死了	usl
收缩膜	usm
十三年	usn
十三篇	usp
双色球	usq
上诉人	usr
十三岁	uss
十三条	ust
上岁数	usu
生死战	usv
十三万	usw
伸缩性	usx
使所有	usy
神算子	usz
收摊啊	uta
手提包	utb
生态村	utc
渗透到	utd
书摊儿	ute
实体法	utf
生态观	utg
身体好	uth
手推车	uti
手头紧	utj
史塔克	utk
伤透了	utl
使他们	utm
施泰纳	utn
身体胖	utp
上台前	utq
受托人	utr
沙滩伞	uts
实体图	utt
实体书	utu
渗透着	utv
上图为	utw
试探性	utx
晒太阳	uty
山桐子	utz
深圳啊	uva
顺朱儿	uve
室主任	uvr
生长素	uvs
设置为	uvw
市中心	uvx
是我啊	uwa
商务部	uwb
鼠尾草	uwc
事物的	uwd
是味儿	uwe
晌午饭	uwf
是我国	uwg
生物化	uwh
商务车	uwi
睡午觉	uwj
上网卡	uwk
是为了	uwl
使我们	uwm
十五年	uwn
十五篇	uwp
生物圈	uwq
水污染	uwr
事务所	uws
啥问题	uwt
是我市	uwu
生物钟	uwv
爽歪歪	uww
生物学	uwx
手腕子	uwz
伤心啊	uxa
上下班	uxb
属性词	uxc
剩下的	uxd
手续费	uxf
肾小管	uxg
说闲话	uxh
双线程	uxi
摄像机	uxj
实现了	uxl
时限内	uxn
上下铺	uxp
市辖区	uxq
收信人	uxr
声学所	uxs
摄像头	uxt
上下文	uxw
时效性	uxx
首先在	uxz
声音啊	uya
上一代	uyd
使用费	uyf
是一个	uyg
商业化	uyh
上一集	uyj
收益率	uyl
十余年	uyn
双眼皮	uyp
试用期	uyq
涮羊肉	uyr
是一所	uys
实验室	uyu
是因为	uyw
适用于	uyy
双鱼座	uyz
十字槽	uzc
上座儿	uze
失踪了	uzl
狮子座	uzz
障碍物	vaw
真笨啊	vba
皱巴巴	vbb
真不错	vbc
找不到	vbd
这拨儿	vbe
这部分	vbf
只不过	vbg
准备好	vbh
找不出	vbi
直播间	vbj
睁不开	vbk
准备了	vbl
这表明	vbm
终不能	vbn
中北欧	vbo
周扒皮	vbp
这笔钱	vbq
这帮人	vbr
争霸赛	vbs
周伯通	vbt
这不是	vbu
找不着	vbv
转变为	vbw
装不下	vbx
直播员	vby
这辈子	vbz
仲裁案	vca
注册了	vcl
只存在	vcz
知道啊	vda
指定的	vdd
正当年	vdn
中东欧	vdo
真烦啊	vfa
直肠癌	via
着急啊	vja
真可爱	vka
真空泵	vkb
赵奎灿	vkc
只看到	vkd
抓空儿	vke
主考官	vkg
中括号	vkh
折扣价	vkj
张可可	vkk
展开了	vkl
至昆明	vkm
这可能	vkn
真可怕	vkp
这口气	vkq
主考人	vkr
中控锁	vks
中控台	vkt
这可是	vku
准考证	vkv
重口味	vkw
只可惜	vkx
睁开眼	vky
朱利安	vla
真厉害	vlh
肿瘤科	vlk
专利权	vlq
这里是	vlu
这两种	vlv
这两位	vlw
治疗组	vlz
真美啊	vma
扎马步	vmb
捉迷藏	vmc
知名度	vmd
照面儿	vme
找麻烦	vmf
这么贵	vmg
这么好	vmh
这么长	vmi
这么久	vmj
这么快	vmk
证明了	vml
真面目	vmm
这么难	vmn
这么拼	vmp
这么巧	vmq
掌门人	vmr
詹姆斯	vms
皱眉头	vmt
这么说	vmu
这么着	vmv
这么晚	vmw
这么想	vmx
这么远	vmy
这么做	vmz
竹内爱	vna
真牛逼	vnb
占内存	vnc
这难道	vnd
执牛耳	vne
詹妮弗	vnf
只能够	vng
智能化	vnh
指南车	vni
滞纳金	vnj
智能卡	vnk
找你了	vnl
祝你们	vnm
周南南	vnn
中南欧	vno
纸尿片	vnp
周年庆	vnq
中年人	vnr
斩男色	vns
这年头	vnt
只能说	vnu
指南针	vnv
智能网	vnw
智能型	vnx
只能用	vny
只能在	vnz
诈骗案	vpa
支票簿	vpb
招牌菜	vpc
长胖点	vpd
照片儿	vpe
真佩服	vpf
装配工	vpg
招聘会	vph
制品厂	vpi
照片集	vpj
真漂亮	vpl
这匹马	vpm
只怕你	vpn
郑佩佩	vpp
支配权	vpq
制片人	vpr
招聘司	vps
装配图	vpt
只怕是	vpu
招聘者	vpv
张平文	vpw
支配下	vpx
占便宜	vpy
诈骗罪	vpz
终期癌	vqa
占全部	vqb
中气层	vqc
正确的	vqd
竹签儿	vqe
证券法	vqf
真奇怪	vqg
证券化	vqh
沼气池	vqi
中秋节	vqj
追穷寇	vqk
站起来	vql
真奇妙	vqm
中青年	vqn
张庆鹏	vqp
知情权	vqq
这群人	vqr
张琴松	vqs
证券通	vqt
站起身	vqu
这其中	vqv
证券网	vqw
准确性	vqx
知其一	vqy
转圈子	vqz
之日起	vrq
真骚啊	vsa
赵四儿	vse
猪头啊	vta
涨停板	vtb
主题词	vtc
重特大	vtd
这天恩	vte
竹筒饭	vtf
只提供	vtg
招贴画	vth
直通车	vti
只听见	vtj
这堂课	vtk
这条路	vtl
真他妈	vtm
赵铁牛	vtn
专题片	vtp
主题曲	vtq
猪头肉	vtr
猪头三	vts
直挺挺	vtt
整体上	vtu
只通知	vtv
镇团委	vtw
重头戏	vtx
止痛药	vty
张贴在	vtz
装傻啊	vua
张治安	vva
竹枝词	vvc
只支持	vvi
政治课	vvk
蜘蛛网	vvw
坠亡案	vwa
中文版	vwb
赵湾村	vwc
周围的	vwd
猪窝儿	vwe
占位符	vwf
这五个	vwg
专委会	vwh
转弯处	vwi
之我见	vwj
张威科	vwk
掌握了	vwl
中文名	vwm
只为你	vwn
折文旁	vwp
中晚期	vwq
植物人	vwr
指纹锁	vws
张闻天	vwt
这位是	vwu
战五渣	vwv
中文网	vww
中文系	vwx
这无疑	vwy
中西部	vxb
展现层	vxc
这些个	vxg
这些话	vxh
照相机	vxj
专修科	vxk
展现了	vxl
这些年	vxn
中心区	vxq
这些人	vxr
珠心算	vxs
直辖市	vxu
只希望	vxw
中小学	vxx
只需要	vxy
这下子	vxz
这一次	vyc
扎伊尔	vye
这一方	vyf
找一个	vyg
制药厂	vyi
注意力	vyl
张艺谋	vym
这一年	vyn
专用品	vyp
这一切	vyq
志愿者	vyv
中英文	vyw
周子安	vza
周总理	vzl
万安村	wac
未安装	wav
文安县	wax
我不爱	wba
我并不	wbb
窝边草	wbc
忘不掉	wbd
围脖儿	wbe
我不服	wbf
我不敢	wbg
我不会	wbh
完不成	wbi
为背景	wbj
文本框	wbk
微波炉	wbl
为避免	wbm
我不能	wbn
我不怕	wbp
玩不起	wbq
我本人	wbr
五百岁	wbs
我不太	wbt
未必是	wbu
为保障	wbv
五百万	wbw
我不想	wbx
务必要	wby
我不在	wbz
我猜啊	wca
我从不	wcb
我猜测	wcc
未曾得	wcd
午餐费	wcf
外侧沟	wcg
午餐后	wch
五彩池	wci
我曾经	wcj
我才看	wck
我错了	wcl
卧槽马	wcm
未采纳	wcn
汪曾祺	wcq
午餐肉	wcr
问苍天	wct
五彩石	wcu
未猜中	wcv
我从未	wcw
我从小	wcx
未曾有	wcy
误操作	wcz
无大碍	wda
我都会	wdh
我当初	wdi
豌豆荚	wdj
玩电脑	wdn
武当派	wdp
外地人	wdr
我打算	wds
万多元	wdy
玩儿啊	wea
威尔伯	web
外耳道	wed
沃尔夫	wef
玩儿个	weg
乌尔禾	weh
玩儿成	wei
威尔基	wej
威尔康	wek
玩儿烂	wel
沃尔玛	wem
玩儿腻	wen
玩儿票	wep
戊二醛	weq
维尔容	wer
威尔斯	wes
沃尔特	wet
威尔士	weu
玩儿转	wev
沃尔沃	wew
威尔逊	wex
威尔鹰	wey
我儿子	wez
胃复安	wfa
我服了	wfl
王国安	wga
为鼓励	wgl
我过去	wgq
外国人	wgr
我公司	wgs
我高兴	wgx
我还能	whn
我害怕	whp
我和他	wht
望长安	wia
无差别	wib
无差错	wic
我差点	wid
吴承恩	wie
我吃饭	wif
文抄公	wig
完成后	wih
我常常	wii
未成交	wij
胃穿孔	wik
完成了	wil
文昌门	wim
未成年	win
望城坡	wip
武昌区	wiq
我承认	wir
武承嗣	wis
无出头	wit
完成时	wiu
维持着	wiv
无臭味	wiw
文成县	wix
胃肠炎	wiy
维持在	wiz
维吉尔	wje
为加强	wjq
我看啊	wka
我可不	wkb
无库存	wkc
我看到	wkd
五块二	wke
未开发	wkf
我看过	wkg
为客户	wkh
万科城	wki
我看见	wkj
我看看	wkk
乌克兰	wkl
为楷模	wkm
我看你	wkn
我恐怕	wkp
温控器	wkq
尾款人	wkr
我哭死	wks
王磡头	wkt
温开水	wku
我看着	wkv
我渴望	wkw
外科学	wkx
我可以	wky
万颗子	wkz
为了爱	wla
我来吧	wlb
五六次	wlc
我懒得	wld
乌拉尔	wle
晚礼服	wlf
五六个	wlg
窝里横	wlh
乌龙茶	wli
为了将	wlj
我离开	wlk
我溜了	wll
完了吗	wlm
为了你	wln
无聊哦	wlo
我老婆	wlp
为了钱	wlq
为了让	wlr
蔚蓝色	wls
无厘头	wlt
无论是	wlu
我拉着	wlv
问了问	wlw
物理学	wlx
五粮液	wly
无论在	wlz
我没啊	wma
为目标	wmb
我们从	wmc
完美的	wmd
沃米尔	wme
我没法	wmf
外蒙古	wmg
文明号	wmh
我们厂	wmi
我们就	wmj
我没看	wmk
我们俩	wml
雾蒙蒙	wmm
我们能	wmn
唯美派	wmp
我们却	wmq
文明人	wmr
我们仨	wms
亡命徒	wmt
我们是	wmu
我们这	wmv
文明委	wmw
我们想	wmx
我们要	wmy
我们在	wmz
问你啊	wna
为哪般	wnb
无奈地	wnd
我女儿	wne
窝囊废	wnf
我能够	wng
五年后	wnh
挖泥船	wni
五年级	wnj
我宁可	wnk
万年历	wnl
为你们	wnm
五年内	wnn
无奈哦	wno
无脑捧	wnp
五年前	wnq
无内容	wnr
威尼斯	wns
我那天	wnt
我能说	wnu
五年制	wnv
玩腻味	wnw
我内心	wnx
我宁愿	wny
我能做	wnz
我怕啊	wpa
尾盘报	wpb
外胚层	wpc
顽皮的	wpd
五盆儿	wpe
我佩服	wpf
顽皮鬼	wpg
为配合	wph
卧铺车	wpi
外婆家	wpj
玩扑克	wpk
我怕了	wpl
我拼命	wpm
我陪你	wpn
我拍拍	wpp
外婆桥	wpq
汪佩蓉	wpr
蛙皮素	wps
无配套	wpt
我平时	wpu
我陪着	wpv
王佩雯	wpw
武平县	wpx
我朋友	wpy
王胖子	wpz
武器啊	wqa
为确保	wqb
温泉村	wqc
无穷大	wqd
五千二	wqe
物权法	wqf
我去过	wqg
万泉河	wqh
问清楚	wqi
挖墙脚	wqj
我请客	wqk
我去了	wql
往前面	wqm
完全能	wqn
网球拍	wqp
我轻轻	wqq
未确认	wqr
网球赛	wqs
问青天	wqt
完全是	wqu
为群众	wqv
五千万	wqw
无穷小	wqx
为企业	wqy
往前走	wqz
温瑞安	wra
吴仁宝	wrb
我认错	wrc
微软的	wrd
乌瑞恩	wre
为人父	wrf
无人管	wrg
为日后	wrh
王瑞昌	wri
无人机	wrj
万人坑	wrk
我忍了	wrl
为人民	wrm
我日你	wrn
我日哦	wro
我人品	wrp
无人区	wrq
我日日	wrr
伍仁酥	wrs
我让她	wrt
我认识	wru
围绕着	wrv
我认为	wrw
侮辱性	wrx
污染源	wry
围绕在	wrz
吴四宝	wsb
无色彩	wsc
萎缩的	wsd
温思尔	wse
未遂犯	wsf
吴三桂	wsg
无损耗	wsh
无色差	wsi
无色界	wsj
吴淞口	wsk
我死了	wsl
威斯敏	wsm
我送你	wsn
乌索普	wsp
无所求	wsq
王斯然	wsr
威瑟斯	wss
文森特	wst
无损伤	wsu
无所住	wsv
无所谓	wsw
萎缩性	wsx
万岁爷	wsy
外孙子	wsz
无头案	wta
乌托邦	wtb
乌塌菜	wtc
为推动	wtd
瓦铁尔	wte
委托方	wtf
为提高	wtg
委托函	wth
味太冲	wti
无条件	wtj
外太空	wtk
我听了	wtl
为他们	wtm
我挺你	wtn
网拓扑	wtp
我抬起	wtq
委托人	wtr
为特色	wts
我天天	wtt
问题是	wtu
为特征	wtv
委托物	wtw
未填写	wtx
我同意	wty
我躺在	wtz
无障碍	wva
完整版	wvb
未注册	wvc
我知道	wvd
我这儿	wve
无政府	wvf
我这个	wvg
我只好	wvh
伪装成	wvi
无止境	wvj
无折扣	wvk
我这里	wvl
未注明	wvm
五周年	wvn
无照片	wvp
万州区	wvq
温州人	wvr
五针松	wvs
为主题	wvt
温州市	wvu
望周知	wvv
我周围	wvw
完整性	wvx
无助于	wvy
我正在	wvz
我想啊	wxa
韦小宝	wxb
无限次	wxc
无线电	wxd
温西尔	wxe
维修费	wxf
维修工	wxg
我喜欢	wxh
维修厂	wxi
五星级	wxj
往下看	wxk
我心里	wxl
我想买	wxm
我想你	wxn
五线谱	wxp
我先去	wxq
外星人	wxr
文学所	wxs
我想他	wxt
王先生	wxu
我心中	wxv
我希望	wxw
我相信	wxx
我需要	wxy
我现在	wxz
我晕啊	wya
网页版	wyb
外逸层	wyc
唯一的	wyd
玩意儿	wye
五月份	wyf
我应该	wyg
我也会	wyh
我要吃	wyi
无意间	wyj
我一看	wyk
我赢了	wyl
我也没	wym
我也能	wyn
我晕哦	wyo
微硬盘	wyp
我以前	wyq
我依然	wyr
位运算	wys
为一体	wyt
无疑是	wyu
无意中	wyv
我以为	wyw
玩游戏	wyx
我愿意	wyy
乌鸦嘴	wyz
我最爱	wza
文字版	wzb
湾子村	wzc
我再顶	wzd
围嘴儿	wze
外祖父	wzf
为祖国	wzg
为做好	wzh
未造成	wzi
我自己	wzj
苇子坑	wzk
屋子里	wzl
我怎么	wzm
我怎能	wzn
我最怕	wzp
五子棋	wzq
无责任	wzr
外资司	wzs
为载体	wzt
我总是	wzu
为宗旨	wzv
我昨晚	wzw
晚自习	wzx
我再也	wzy
我坐在	wzz
许安安	xaa
新安村	xac
西奥多	xad
性爱抚	xaf
性爱观	xag
许鞍华	xah
心安处	xai
新安江	xaj
相爱了	xal
兴安盟	xam
想爱你	xan
消癌平	xap
翔安区	xaq
小矮人	xar
缬氨酸	xas
谢安桐	xat
西安市	xau
先安装	xav
邢傲伟	xaw
献爱心	xax
小阿姨	xay
小矮子	xaz
下班啊	xba
下次吧	xcb
下曹村	xcc
西餐店	xcd
雄蚕蛾	xce
胁从犯	xcf
小餐馆	xcg
新词汇	xch
线材厂	xci
下次见	xcj
小仓库	xck
新材料	xcl
小聪明	xcm
笑翠鸟	xcn
协操坪	xcp
香草醛	xcq
香菜日	xcr
香菜碎	xcs
西餐厅	xct
性措施	xcu
幸存者	xcv
小错误	xcw
修辞学	xcx
小测验	xcy
小册子	xcz
修订案	xda
行动吧	xdb
许多次	xdc
小弟弟	xdd
鞋带儿	xde
新东方	xdf
信得过	xdg
现代化	xdh
蓄电池	xdi
洗涤剂	xdj
想得开	xdk
想到了	xdl
兄弟们	xdm
许多年	xdn
现代派	xdp
消毒器	xdq
许多人	xdr
香豆素	xds
行得通	xdt
许多事	xdu
行动中	xdv
小动物	xdw
写东西	xdx
相当于	xdy
小动作	xdz
邪恶爱	xea
夏尔巴	xeb
新二村	xec
希尔顿	xed
肖恩恩	xee
希尔芙	xef
谢尔盖	xeg
西二环	xeh
细而长	xei
小而精	xej
小儿科	xek
性恶论	xel
谢尔曼	xem
小儿女	xen
西恩潘	xep
小而全	xeq
心恶热	xer
西尔斯	xes
刑二庭	xet
形而上	xeu
邪恶者	xev
席尔瓦	xew
形而下	xex
小恩雅	xey
小儿子	xez
新方案	xfa
信访办	xfb
想发财	xfc
兴奋的	xfd
戏份儿	xfe
新方法	xff
幸福感	xfg
相符合	xfh
消防车	xfi
兴奋剂	xfj
消费卡	xfk
下发了	xfl
幸福吗	xfm
小放牛	xfn
须浮鸥	xfo
消费品	xfp
消费群	xfq
西方人	xfr
新粉丝	xfs
下腹痛	xft
洗发水	xfu
消费者	xfv
新服务	xfw
新发现	xfx
消防员	xfy
想法子	xfz
修改案	xga
修改版	xgb
香根草	xgc
相关的	xgd
香干儿	xge
下功夫	xgf
小哥哥	xgg
效果好	xgh
性高潮	xgi
膝关节	xgj
谢广坤	xgk
习惯了	xgl
小规模	xgm
新概念	xgn
西瓜皮	xgp
修改器	xgq
香港人	xgr
新公司	xgs
效果图	xgt
习惯上	xgu
小公主	xgv
小怪物	xgw
习惯性	xgx
习惯于	xgy
洗个澡	xgz
西海岸	xha
小伙伴	xhb
杏花村	xhc
喜欢的	xhd
小孩儿	xhe
新回复	xhf
新华光	xhg
笑呵呵	xhh
喜欢吃	xhi
相互间	xhj
消化科	xhk
学会了	xhl
小红帽	xhm
喜欢你	xhn
消耗品	xhp
徐汇区	xhq
吓唬人	xhr
鲜红色	xhs
喜欢他	xht
西红柿	xhu
向后转	xhv
小黑屋	xhw
下划线	xhx
相呼应	xhy
小孩子	xhz
袭警案	xja
性价比	xjb
下酒菜	xjc
现阶段	xjd
心劲儿	xje
选举法	xjf
小酒馆	xjg
相结合	xjh
小轿车	xji
小姐姐	xjj
新街口	xjk
下结论	xjl
新局面	xjm
想见你	xjn
新加坡	xjp
陷进去	xjq
选举人	xjr
性激素	xjs
心绞痛	xjt
新技术	xju
向记者	xjv
县纪委	xjw
下决心	xjx
相较于	xjy
小舅子	xjz
辛苦了	xkl
锡克族	xkz
西来庵	xla
星奈爱	xna
小女儿	xne
吸欧气	xoq
西欧人	xor
新偶像	xox
姓欧阳	xoy
稀奇啊	xqa
星期六	xql
向全球	xqq
星期天	xqt
新气象	xqx
陷入了	xrl
硝酸铵	xsa
西三环	xsh
消色差	xsi
西三旗	xsq
性骚扰	xsr
泄题案	xta
小天鹅	xte
希特勒	xtl
小缇娜	xtn
心太软	xtr
凶杀案	xua
修正案	xva
行政部	xvb
行政村	xvc
显著的	xvd
下周二	xve
县政府	xvf
新中国	xvg
瞎指挥	xvh
行政处	xvi
限制级	xvj
新周刊	xvk
修正了	xvl
下周末	xvm
下中农	xvn
写这篇	xvp
行政区	xvq
下周日	xvr
下周三	xvs
瞎折腾	xvt
笑着说	xvu
象征着	xvv
下周五	xvw
象征性	xvx
下周一	xvy
限制在	xvz
想文案	xwa
新闻办	xwb
洗物槽	xwc
谢文东	xwd
小娃儿	xwe
新玩法	xwf
新闻稿	xwg
下午好	xwh
下午茶	xwi
显微镜	xwj
胸外科	xwk
想歪了	xwl
向我们	xwm
希望能	xwn
想我哦	xwo
新闻片	xwp
宣武区	xwq
行为人	xwr
纤维素	xws
新问题	xwt
新闻社	xwu
学位证	xwv
新闻网	xww
新闻学	xwx
夏威夷	xwy
小王子	xwz
性与爱	xya
现在啊	xza
心脏病	xzb
现在才	xzc
现在都	xzd
下崽儿	xze
学杂费	xzf
选择过	xzg
下载后	xzh
修造厂	xzi
现在就	xzj
选择框	xzk
写字楼	xzl
瞎琢磨	xzm
现在呢	xzn
新作品	xzp
选择权	xzq
学做人	xzr
小组赛	xzs
选择题	xzt
现在是	xzu
下载站	xzv
写作文	xzw
选择性	xzx
写作业	xzy
喜滋滋	xzz
有病啊	yba
乙草胺	yca
印第安	yda
一大半	ydb
一道菜	ydc
一点点	ydd
一点儿	yde
一顿饭	ydf
遇到过	ydg
一定会	ydh
一大串	ydi
一等奖	ydj
一大块	ydk
意大利	ydl
源代码	ydm
一定能	ydn
一大批	ydp
阅读器	ydq
有的人	ydr
胰岛素	yds
冤大头	ydt
一定是	ydu
用得着	ydv
一大碗	ydw
有点像	ydx
一定要	ydy
一大早	ydz
缘分啊	yfa
也分别	yfb
要服从	yfc
衣服的	yfd
意粉儿	yfe
一幅幅	yff
与法国	yfg
一番话	yfh
有非常	yfi
优抚金	yfj
预付款	yfk
引发了	yfl
一方面	yfm
益肤宁	yfn
依凡欧	yfo
预分配	yfp
一分钱	yfq
与繁荣	yfr
已发送	yfs
阎浮提	yft
易发生	yfu
一分钟	yfv
又分为	yfw
一封信	yfx
依附于	yfy
一分子	yfz
由公安	yga
一个半	ygb
一个词	ygc
一贯的	ygd
压根儿	yge
一公分	ygf
一个个	ygg
应该会	ygh
与工程	ygi
由国家	ygj
与顾客	ygk
英格兰	ygl
一感冒	ygm
应该能	ygn
预告片	ygp
已过期	ygq
一个人	ygr
与公司	ygs
与沟通	ygt
应该是	ygu
也跟着	ygv
与国外	ygw
有关系	ygx
一个月	ygy
一个字	ygz
也卡啊	yka
已立案	yla
一览表	ylb
一两次	ylc
有力的	yld
爷俩儿	yle
医疗费	ylf
有两个	ylg
以良好	ylh
一连串	yli
养老金	ylj
伊拉克	ylk
迎来了	yll
一厘米	ylm
一两年	yln
袁隆平	ylp
娱乐圈	ylq
一路人	ylr
有类似	yls
一两天	ylt
原来是	ylu
有两种	ylv
原谅我	ylw
依赖性	ylx
越来越	yly
一揽子	ylz
郁闷啊	yma
有毛病	ymb
莜麦菜	ymc
有名的	ymd
爷们儿	yme
有免费	ymf
幽默感	ymg
一抹黑	ymh
杨梅疮	ymi
也没见	ymj
衙门口	ymk
阴谋论	yml
一幕幕	ymm
以每年	ymn
郁闷哦	ymo
燕麦片	ymp
羽毛球	ymq
野蛮人	ymr
亚麻酸	yms
有媒体	ymt
一码事	ymu
一秒钟	ymv
有名望	ymw
亚马逊	ymx
有没有	ymy
夜猫子	ymz
以年爱	yna
一年半	ynb
野牛草	ync
一年多	ynd
义男儿	yne
羊奶粉	ynf
有哪个	yng
一年后	ynh
有难处	yni
一年级	ynj
一乃葵	ynk
有能力	ynl
有那么	ynm
一年内	ynn
意难平	ynp
一年前	ynq
有女人	ynr
尤努斯	yns
有年头	ynt
云南省	ynu
遇难者	ynv
有内味	ynw
有哪些	ynx
与农业	yny
有你在	ynz
与欧盟	yom
印欧人	yor
与欧洲	yov
印欧语	yoy
杨培安	ypa
硬盘版	ypb
一盘菜	ypc
又跑到	ypd
一盆儿	ype
样品费	ypf
压迫感	ypg
以配合	yph
用品厂	ypi
月平均	ypj
月票卡	ypk
有魄力	ypl
一平米	ypm
一泡尿	ypn
一片片	ypp
一盘棋	ypq
影评人	ypr
优婆塞	yps
与普通	ypt
月偏食	ypu
应聘者	ypv
有品位	ypw
音频线	ypx
硬碰硬	ypy
眼皮子	ypz
有钱啊	yqa
有区别	yqb
油气藏	yqc
一切都	yqd
忆秦娥	yqe
右前方	yqf
一千个	yqg
爷青回	yqh
一起吃	yqi
元器件	yqj
一千克	yqk
引起了	yql
要全面	yqm
一千年	yqn
以欺骗	yqp
一起去	yqq
一群人	yqr
有起色	yqs
有前途	yqt
尤其是	yqu
有气质	yqv
一千万	yqw
有缺陷	yqx
有求于	yqy
一清早	yqz
引入了	yrl
意思啊	ysa
以色列	ysl
压岁钱	ysq
胰头癌	yta
一直按	yva
圆珠笔	yvb
与政策	yvc
优质的	yvd
一阵儿	yve
与政府	yvf
由中国	yvg
一枝花	yvh
一盏茶	yvi
邮政局	yvj
优质课	yvk
意志力	yvl
验证码	yvm
一周年	yvn
一张牌	yvp
业主群	yvq
意中人	yvr
硬脂酸	yvs
一整天	yvt
一直是	yvu
严重者	yvv
与周围	yvw
严重性	yvx
有助于	yvy
一直在	yvz
因为爱	ywa
英文版	ywb
业务层	ywc
意外的	ywd
洋味儿	ywe
一窝蜂	ywf
一万个	ywg
有文化	ywh
已完成	ywi
源文件	ywj
依我看	ywk
与网络	ywl
英文名	ywm
一万年	ywn
因为哦	ywo
洋务派	ywp
一文钱	ywq
义务人	ywr
医务所	yws
有问题	ywt
以为是	ywu
意味着	ywv
洋娃娃	yww
意外险	ywx
业务员	ywy
与外资	ywz
胰腺癌	yxa
也许吧	yxb
鱼腥草	yxc
有许多	yxd
一小儿	yxe
右下方	yxf
一些个	yxg
也许会	yxh
涌现出	yxi
优先级	yxj
一小块	yxk
一系列	yxl
音形码	yxm
也许能	yxn
印象派	yxp
有效期	yxq
有些人	yxr
预选赛	yxs
一线天	yxt
也许是	yxu
影响着	yxv
一下午	yxw
有效性	yxx
医学院	yxy
一下子	yxz
最昂贵	zag
在安徽	zah
曾阿牛	zan
组氨酸	zas
棕矮星	zax
早坂爱	zba
咱爸爸	zbb
在本次	zbc
做不到	zbd
资本额	zbe
在部分	zbf
自卑感	zbg
总不会	zbh
做不出	zbi
资本家	zbj
走不开	zbk
做不了	zbl
在北美	zbm
总不能	zbn
滋补品	zbp
坐便器	zbq
再比如	zbr
在比赛	zbs
在不同	zbt
则表示	zbu
坐不住	zbv
做不完	zbw
坐标系	zbx
遭报应	zby
在不在	zbz
组策略	zcl
早餐奶	zcn
在厕所	zcs
自动化	zdh
在调查	zdi
最低价	zdj
在贷款	zdk
做到了	zdl
自动炮	zdp
在冬天	zdt
在大学	zdx
在儿童	zet
最方便	zfb
做饭菜	zfc
在法定	zfd
紫枫儿	zfe
在法国	zfg
最繁华	zfh
字符串	zfi
坐飞机	zfj
暂付款	zfk
在法律	zfl
在父母	zfm
揍飞你	zfn
再分配	zfp
在父亲	zfq
尊夫人	zfr
在飞速	zfs
在法庭	zft
在分析	zfx
最复杂	zfz
子宫癌	zga
在规定	zgd
最高峰	zgf
走过场	zgi
走过去	zgq
在个人	zgr
自顾自	zgz
纵火案	zha
脏活儿	zhe
在合肥	zhf
脏乎乎	zhh
走回家	zhj
在后期	zhq
在韩日	zhr
紫红色	zhs
在合同	zht
在会上	zhu
在海外	zhw
综合性	zhx
最后一	zhy
最好在	zhz
走出去	ziq
总经理	zjl
再加强	zjq
自觉性	zjx
最可爱	zka
自考办	zkb
总库存	zkc
在看到	zkd
在开发	zkf
总开关	zkg
在客户	zkh
在考察	zki
在科技	zkj
再看看	zkk
自控力	zkl
在昆明	zkm
最困难	zkn
最可怕	zkp
在空气	zkq
在快速	zks
在课堂	zkt
最开始	zku
在空中	zkv
自考网	zkw
在科学	zkx
则可以	zky
钻空子	zkz
走了啊	zla
在路边	zlb
在两次	zlc
在伦敦	zld
自留额	zle
租赁房	zlf
在两个	zlg
最厉害	zlh
在临床	zli
在了解	zlj
资料库	zlk
紫罗兰	zll
在里面	zlm
在辽宁	zln
走了哦	zlo
资料片	zlp
租赁期	zlq
最令人	zlr
在拉萨	zls
在论坛	zlt
在路上	zlu
在兰州	zlv
租赁物	zlw
最理想	zlx
坐落于	zly
坐落在	zlz
怎么啊	zma
怎么办	zmb
在每次	zmc
怎么都	zmd
总名额	zme
怎么发	zmf
在每个	zmg
怎么会	zmh
在漫长	zmi
怎么就	zmj
怎么看	zmk
怎么了	zml
做买卖	zmm
怎么能	zmn
怎么跑	zmp
在目前	zmq
怎么让	zmr
怎么算	zms
自媒体	zmt
怎么说	zmu
怎么着	zmv
怎么玩	zmw
怎么行	zmx
怎么样	zmy
怎么做	zmz
在哪啊	zna
在那边	znb
在农村	znc
在内地	znd
在哪儿	zne
在南方	znf
在那个	zng
在脑后	znh
在南昌	zni
早年间	znj
最难看	znk
在那里	znl
在你们	znm
在南宁	znn
灾难片	znp
最年轻	znq
在男人	znr
枣泥酥	zns
最难听	znt
在那时	znu
子女者	znv
最难忘	znw
灾难性	znx
在农业	zny
在男子	znz
在旁边	zpb
曾沛慈	zpc
在平等	zpd
在谱儿	zpe
在批发	zpf
醉排骨	zpg
再配合	zph
在平常	zpi
作品集	zpj
在贫困	zpk
最漂亮	zpl
在屏幕	zpm
在品牌	zpp
最贫穷	zpq
在平日	zpr
最朴素	zps
在普通	zpt
在拍摄	zpu
作品展	zpv
在骗我	zpw
在培训	zpx
最便宜	zpy
左撇子	zpz
增强版	zqb
在其次	zqc
在确定	zqd
足球儿	zqe
左前方	zqf
藏青果	zqg
曾庆红	zqh
在汽车	zqi
作曲家	zqj
曾秋坤	zqk
坐起来	zql
最起码	zqm
在去年	zqn
最奇葩	zqp
走亲戚	zqq
在确认	zqr
足球赛	zqs
在其他	zqt
在全省	zqu
在其中	zqv
最权威	zqw
增强型	zqx
在企业	zqy
做妻子	zqz
总人口	zrk
在人类	zrl
自然派	zrp
在日前	zrq
责任人	zrr
自认为	zrw
责任心	zrx
最容易	zry
走私案	zsa
在苏州	zsv
在死亡	zsw
佐藤爱	zta
在台北	ztb
字体册	ztc
在他的	ztd
字帖儿	zte
总统府	ztf
在提高	ztg
座谈会	zth
最突出	zti
在提交	ztj
在天空	ztk
增添了	ztl
在他们	ztm
在体内	ztn
棕头鸥	zto
在谈判	ztp
在听取	ztq
总投入	ztr
在探索	zts
最头疼	ztt
总体上	ztu
在调整	ztv
在台湾	ztw
在同学	ztx
最讨厌	zty
总投资	ztz
佐山爱	zua
在室内	zun
在申请	zuq
组织胺	zva
在玩啊	zwa
滋味儿	zwe
在我方	zwf
在我国	zwg
组委会	zwh
在文件	zwj
在网络	zwl
最完美	zwm
最温暖	zwn
则完全	zwq
在微软	zwr
最无私	zws
作文题	zwt
在网上	zwu
在我这	zwv
作为我	zww
紫外线	zwx
在西安	zxa
最新版	zxb
遭雪藏	zxc
在现代	zxd
走形儿	zxe
左下方	zxf
在香港	zxg
最喜欢	zxh
自行车	zxi
左下角	zxj
仔细看	zxk
在心里	zxl
在下面	zxm
早些年	zxn
走下坡	zxp
走下去	zxq
最吓人	zxr
自旋锁	zxs
子系统	zxt
在校生	zxu
在寻找	zxv
总希望	zxw
自信心	zxx
最需要	zxy
在选择	zxz
罪与爱	zya
做一个	zyg
在一场	zyi
遭遇了	zyl
在一年	zyn
在一起	zyq
自以为	zyw
在一些	zyx
在最后	zzh
在自己	zzj
走走看	zzk
在走廊	zzl
在早期	zzq
在昨日	zzr
自尊心	zzx
